state_name,county_fips,county_name,votes_gop,votes_dem,total_votes,diff,per_gop,per_dem,per_point_diff
Alabama,1001,Autauga County,19764,7450,27639,12314,0.715076522,0.269546655,0.445529867
Alabama,1003,Baldwin County,83055,24344,108945,58711,0.762357153,0.223452201,0.538904952
Alabama,1005,Barbour County,5605,4772,10457,833,0.53600459,0.456345032,0.079659558
Alabama,1007,Bibb County,7508,1982,9573,5526,0.784289147,0.207040635,0.577248511
Alabama,1009,Blount County,24595,2627,27459,21968,0.895699042,0.095669908,0.800029134
Alabama,1011,Bullock County,1143,3439,4603,-2296,0.248316315,0.747121443,-0.498805127
Alabama,1013,Butler County,5448,3953,9466,1495,0.575533488,0.417599831,0.157933657
Alabama,1015,Calhoun County,34964,15118,50743,19846,0.689040853,0.29793272,0.391108133
Alabama,1017,Chambers County,8748,6356,15269,2392,0.572925535,0.416268256,0.156657279
Alabama,1019,Cherokee County,10562,1619,12275,8943,0.860448065,0.131894094,0.728553971
Alabama,1021,Chilton County,16052,3056,19260,12996,0.833437175,0.15867082,0.674766355
Alabama,1023,Choctaw County,4294,3126,7461,1168,0.575526069,0.418978689,0.15654738
Alabama,1025,Clarke County,7310,5730,13102,1580,0.557930087,0.437337811,0.120592276
Alabama,1027,Clay County,5589,1262,6913,4327,0.808476783,0.182554607,0.625922176
Alabama,1029,Cleburne County,6472,672,7210,5800,0.897642164,0.093203883,0.80443828
Alabama,1031,Coffee County,16832,5050,22180,11782,0.758881876,0.227682597,0.531199279
Alabama,1033,Colbert County,17311,7057,24668,10254,0.701759364,0.286079131,0.415680234
Alabama,1035,Conecuh County,3435,2951,6419,484,0.535130083,0.45972893,0.075401153
Alabama,1037,Coosa County,3626,1794,5472,1832,0.662646199,0.327850877,0.334795322
Alabama,1039,Covington County,14579,2717,17418,11862,0.837007693,0.155988058,0.681019635
Alabama,1041,Crenshaw County,4864,1700,6617,3164,0.735076319,0.256914009,0.478162309
Alabama,1043,Cullman County,36804,4454,41751,32350,0.88151182,0.10668008,0.774831741
Alabama,1045,Dale County,14281,5154,19699,9127,0.724960658,0.261637647,0.463323011
Alabama,1047,Dallas County,5523,12228,17861,-6705,0.309221208,0.684620122,-0.375398914
Alabama,1049,DeKalb County,24744,4271,29322,20473,0.843871496,0.14565855,0.698212946
Alabama,1051,Elmore County,30089,10304,40891,19785,0.735834291,0.25198699,0.483847301
Alabama,1053,Escambia County,10844,4894,15861,5950,0.683689553,0.308555577,0.375133976
Alabama,1055,Etowah County,35343,11487,47460,23856,0.744690265,0.242035398,0.502654867
Alabama,1057,Fayette County,7295,1390,8756,5905,0.833142988,0.158748287,0.674394701
Alabama,1059,Franklin County,10364,2085,12564,8279,0.82489653,0.165950334,0.658946195
Alabama,1061,Geneva County,10844,1592,12538,9252,0.864890732,0.126973999,0.737916733
Alabama,1063,Greene County,875,3880,4771,-3005,0.183399707,0.813246699,-0.629846992
Alabama,1065,Hale County,3190,4687,7922,-1497,0.402676092,0.591643524,-0.188967432
Alabama,1067,Henry County,6593,2589,9266,4004,0.711526009,0.279408591,0.432117419
Alabama,1069,Houston County,32384,12738,45750,19646,0.707846995,0.27842623,0.429420765
Alabama,1071,Jackson County,19644,3709,23602,15935,0.832302347,0.157147699,0.675154648
Alabama,1073,Jefferson County,138443,180936,324675,-42493,0.426404866,0.557283437,-0.130878571
Alabama,1075,Lamar County,6168,978,7187,5190,0.858216224,0.136079032,0.722137192
Alabama,1077,Lauderdale County,31578,11872,44149,19706,0.715259689,0.268907563,0.446352126
Alabama,1079,Lawrence County,12266,3544,15957,8722,0.768690857,0.222096885,0.546593971
Alabama,1081,Lee County,42019,27600,70980,14419,0.591983657,0.388841927,0.20314173
Alabama,1083,Limestone County,34337,13510,48754,20827,0.70429093,0.277105468,0.427185462
Alabama,1085,Lowndes County,1835,4968,6830,-3133,0.268667643,0.727379209,-0.458711567
Alabama,1087,Macon County,1539,7084,8697,-5545,0.176957572,0.814533747,-0.637576176
Alabama,1089,Madison County,102395,86885,193955,15510,0.527931737,0.447964734,0.079967003
Alabama,1091,Marengo County,5337,5476,10882,-139,0.490442933,0.503216321,-0.012773387
Alabama,1093,Marion County,12190,1457,13786,10733,0.884230379,0.105686929,0.77854345
Alabama,1095,Marshall County,33094,5880,39492,27214,0.837992505,0.148890915,0.68910159
Alabama,1097,Mobile County,100605,78754,181783,21851,0.55343459,0.43323083,0.120203759
Alabama,1099,Monroe County,6129,4425,10620,1704,0.577118644,0.416666667,0.160451977
Alabama,1101,Montgomery County,33122,64065,98476,-30943,0.336345912,0.650564605,-0.314218693
Alabama,1103,Morgan County,39504,13159,53482,26345,0.738641038,0.246045398,0.49259564
Alabama,1105,Perry County,1336,3849,5215,-2513,0.256184084,0.738063279,-0.481879195
Alabama,1107,Pickens County,5590,4017,9659,1573,0.578734859,0.415881561,0.162853297
Alabama,1109,Pike County,8020,5613,13796,2407,0.581327921,0.40685706,0.174470861
Alabama,1111,Randolph County,8548,2203,10824,6345,0.789726534,0.203529194,0.586197339
Alabama,1113,Russell County,9796,11078,21108,-1282,0.464089445,0.524824711,-0.060735266
Alabama,1115,St. Clair County,36119,7698,44346,28421,0.814481577,0.173589501,0.640892076
Alabama,1117,Shelby County,79428,33036,114439,46392,0.694064087,0.288677811,0.405386276
Alabama,1119,Sumter County,1598,4639,6282,-3041,0.254377587,0.738459089,-0.484081503
Alabama,1121,Talladega County,22210,13092,35591,9118,0.624034166,0.367845804,0.256188362
Alabama,1123,Tallapoosa County,14905,5815,20888,9090,0.713567599,0.278389506,0.435178093
Alabama,1125,Tuscaloosa County,50961,37514,89760,13447,0.567747326,0.41793672,0.149810606
Alabama,1127,Walker County,25947,4826,31106,21121,0.834147753,0.155146917,0.679000836
Alabama,1129,Washington County,6554,2253,8861,4301,0.739645638,0.254260242,0.485385397
Alabama,1131,Wilcox County,1826,4036,5884,-2210,0.310333107,0.68592794,-0.375594833
Alabama,1133,Winston County,10187,974,11273,9213,0.903663621,0.086401135,0.817262486
Arizona,4001,Apache County,7491,16574,24333,-9083,0.307853532,0.681132618,-0.373279086
Arizona,4003,Cochise County,31265,21980,54381,9285,0.574925066,0.404185285,0.17073978
Arizona,4005,Coconino County,26519,44103,72110,-17584,0.367757593,0.611607267,-0.243849674
Arizona,4007,Gila County,18375,8943,27726,9432,0.662735339,0.322549232,0.340186107
Arizona,4009,Graham County,10747,4034,15026,6713,0.71522694,0.268467989,0.446758951
Arizona,4011,Greenlee County,2433,1182,3692,1251,0.658992416,0.320151679,0.338840737
Arizona,4012,La Paz County,4542,2050,6677,2492,0.680245619,0.307024113,0.373221507
Arizona,4013,Maricopa County,977495,1023516,2039433,-46021,0.479297432,0.501863018,-0.022565586
Arizona,4015,Mohave County,77724,24687,103836,53037,0.748526523,0.237749913,0.510776609
Arizona,4017,Navajo County,27417,23217,51464,4200,0.532741334,0.451130888,0.081610446
Arizona,4019,Pima County,197183,295049,501058,-97866,0.393533284,0.588851989,-0.195318706
Arizona,4021,Pinal County,92954,67814,163455,25140,0.568682512,0.414878713,0.153803799
Arizona,4023,Santa Cruz County,6179,13121,19546,-6942,0.316126062,0.671288243,-0.355162182
Arizona,4025,Yavapai County,90280,49111,141719,41169,0.63703526,0.346537867,0.290497393
Arizona,4027,Yuma County,35766,31562,68427,4204,0.522688412,0.461250676,0.061437737
Arkansas,5001,Arkansas County,4301,1813,6284,2488,0.684436665,0.288510503,0.395926162
Arkansas,5003,Ashley County,5540,2119,7911,3421,0.700290734,0.267854886,0.432435849
Arkansas,5005,Baxter County,15810,4625,20968,11185,0.754006105,0.220574208,0.533431896
Arkansas,5007,Benton County,73605,41894,119166,31711,0.617667791,0.351560009,0.266107782
Arkansas,5009,Boone County,13644,3061,17103,10583,0.79775478,0.178974449,0.618780331
Arkansas,5011,Bradley County,2332,1208,3644,1124,0.639956092,0.331503842,0.30845225
Arkansas,5013,Calhoun County,1609,467,2143,1142,0.750816612,0.217918805,0.532897807
Arkansas,5015,Carroll County,7352,3941,11639,3411,0.631669387,0.338602973,0.293066415
Arkansas,5017,Chicot County,1750,2252,4093,-502,0.427559247,0.550207672,-0.122648424
Arkansas,5019,Clark County,6432,5341,12235,1091,0.525704945,0.436534532,0.089170413
Arkansas,5021,Clay County,4084,959,5178,3125,0.788721514,0.185206643,0.603514871
Arkansas,5023,Cleburne County,10292,1962,12617,8330,0.815724816,0.155504478,0.660220338
Arkansas,5025,Cleveland County,2857,649,3588,2208,0.796265329,0.180880713,0.615384615
Arkansas,5027,Columbia County,5469,2781,8550,2688,0.639649123,0.325263158,0.314385965
Arkansas,5029,Conway County,5672,2593,8641,3079,0.656405509,0.300081009,0.356324499
Arkansas,5031,Craighead County,25482,11854,38364,13628,0.664216453,0.308987593,0.35522886
Arkansas,5033,Crawford County,18566,4936,24025,13630,0.772778356,0.205452653,0.567325702
Arkansas,5035,Crittenden County,7244,8325,16086,-1081,0.450329479,0.517530772,-0.067201293
Arkansas,5037,Cross County,4928,1759,6911,3169,0.713066126,0.254521777,0.45854435
Arkansas,5039,Dallas County,1573,963,2649,610,0.593808985,0.363533409,0.230275576
Arkansas,5041,Desha County,1920,2016,4163,-96,0.461205861,0.484266154,-0.023060293
Arkansas,5043,Drew County,4338,2408,6879,1930,0.630614915,0.350050879,0.280564035
Arkansas,5045,Faulkner County,34338,18267,54264,16071,0.632795223,0.336632021,0.296163202
Arkansas,5047,Franklin County,5664,1298,7113,4366,0.796288486,0.182482778,0.613805708
Arkansas,5049,Fulton County,3944,1031,5098,2913,0.77363672,0.202236171,0.571400549
Arkansas,5051,Garland County,29065,14043,44193,15022,0.657683344,0.317765257,0.339918087
Arkansas,5053,Grant County,6791,1268,8197,5523,0.828473832,0.154690741,0.673783091
Arkansas,5055,Greene County,12651,3045,16066,9606,0.787439313,0.189530686,0.597908627
Arkansas,5057,Hempstead County,8067,3294,11835,4773,0.681622307,0.278326996,0.403295311
Arkansas,5059,Hot Spring County,9178,3053,12503,6125,0.734063825,0.244181396,0.489882428
Arkansas,5061,Howard County,3358,1333,4818,2025,0.696969697,0.276670818,0.420298879
Arkansas,5063,Independence County,11232,2798,14486,8434,0.775369322,0.193152009,0.582217313
Arkansas,5065,Izard County,4615,1019,5792,3596,0.796788674,0.17593232,0.620856354
Arkansas,5067,Jackson County,3583,1360,5076,2223,0.705870764,0.267927502,0.437943262
Arkansas,5069,Jefferson County,9500,14882,25030,-5382,0.379544547,0.59456652,-0.215021974
Arkansas,5071,Johnson County,6867,2262,9402,4605,0.730376516,0.240587109,0.489789407
Arkansas,5073,Lafayette County,1730,820,2633,910,0.657045196,0.311431827,0.345613369
Arkansas,5075,Lawrence County,4569,1080,5857,3489,0.780092197,0.184394741,0.595697456
Arkansas,5077,Lee County,1286,1423,2848,-137,0.451544944,0.499648876,-0.048103933
Arkansas,5079,Lincoln County,2725,1031,3870,1694,0.704134367,0.266408269,0.437726098
Arkansas,5081,Little River County,3714,1226,5178,2488,0.717265353,0.236770954,0.480494399
Arkansas,5083,Logan County,6438,1544,8222,4894,0.783021163,0.187788859,0.595232304
Arkansas,5085,Lonoke County,22884,6684,30660,16200,0.746379648,0.218003914,0.528375734
Arkansas,5087,Madison County,5630,1555,7315,4075,0.769651401,0.212576897,0.557074504
Arkansas,5089,Marion County,5767,1526,7481,4241,0.770886245,0.203983425,0.56690282
Arkansas,5091,Miller County,11907,4235,16506,7672,0.721374046,0.256573367,0.464800679
Arkansas,5093,Mississippi County,7262,4542,12287,2720,0.591031171,0.369658989,0.221372182
Arkansas,5095,Monroe County,1545,1146,2815,399,0.548845471,0.407104796,0.141740675
Arkansas,5097,Montgomery County,3021,722,3839,2299,0.786923678,0.18806981,0.598853868
Arkansas,5099,Nevada County,2133,1076,3358,1057,0.635199524,0.320428827,0.314770697
Arkansas,5101,Newton County,3192,709,3998,2483,0.7983992,0.177338669,0.62106053
Arkansas,5103,Ouachita County,5253,3395,8993,1858,0.584120983,0.377515846,0.206605137
Arkansas,5105,Perry County,3466,1005,4607,2461,0.752333406,0.218146299,0.534187107
Arkansas,5107,Phillips County,2393,3561,6155,-1168,0.388789602,0.578554021,-0.189764419
Arkansas,5109,Pike County,3519,644,4246,2875,0.828780028,0.151672162,0.677107866
Arkansas,5111,Poinsett County,5852,1388,7418,4464,0.788891885,0.187112429,0.601779455
Arkansas,5113,Polk County,7018,1242,8468,5776,0.828767123,0.146669816,0.682097308
Arkansas,5115,Pope County,18041,5747,24367,12294,0.740386588,0.235851767,0.504534822
Arkansas,5117,Prairie County,2764,646,3465,2118,0.797691198,0.186435786,0.611255411
Arkansas,5119,Pulaski County,62389,98855,165468,-36466,0.377045713,0.597426693,-0.22038098
Arkansas,5121,Randolph County,5327,1203,6769,4124,0.78697001,0.177721968,0.609248043
Arkansas,5123,St. Francis County,3221,3571,7054,-350,0.456620357,0.506237596,-0.049617238
Arkansas,5125,Saline County,39519,16042,56903,23477,0.694497654,0.281918352,0.412579302
Arkansas,5127,Scott County,1790,364,2219,1426,0.806669671,0.164037855,0.642631816
Arkansas,5129,Searcy County,3365,587,4018,2778,0.837481334,0.146092583,0.691388751
Arkansas,5131,Sebastian County,31024,14371,46838,16653,0.662368163,0.306823519,0.355544643
Arkansas,5133,Sevier County,3884,1116,5202,2768,0.746635909,0.214532872,0.532103037
Arkansas,5135,Sharp County,5923,1392,7544,4531,0.785127253,0.184517497,0.600609756
Arkansas,5137,Stone County,4605,1173,5919,3432,0.778003041,0.198175367,0.579827674
Arkansas,5139,Union County,10446,5559,16548,4887,0.631254532,0.335931835,0.295322698
Arkansas,5141,Van Buren County,5962,1566,7704,4396,0.773883697,0.203271028,0.570612669
Arkansas,5143,Washington County,47229,43327,93467,3902,0.505301336,0.463553982,0.041747355
Arkansas,5145,White County,24057,5909,30689,18148,0.78389651,0.19254456,0.59135195
Arkansas,5147,Woodruff County,1543,849,2469,694,0.624949372,0.343863913,0.28108546
Arkansas,5149,Yell County,5205,1275,6711,3930,0.775592311,0.189986589,0.585605722
California,6001,Alameda County,80504,407954,498082,-327450,0.161628005,0.819049875,-0.65742187
California,6003,Alpine County,238,473,736,-235,0.323369565,0.642663043,-0.319293478
California,6005,Amador County,13503,8095,22234,5408,0.607313124,0.364082037,0.243231088
California,6007,Butte County,46370,48629,97720,-2259,0.474519034,0.497636103,-0.023117069
California,6009,Calaveras County,13275,8804,22506,4471,0.589842709,0.391184573,0.198658136
California,6011,Colusa County,4399,3114,7672,1285,0.573383733,0.405891554,0.167492179
California,6013,Contra Costa County,125703,363370,498340,-237667,0.252243448,0.729160814,-0.476917366
California,6015,Del Norte County,6201,4565,11066,1636,0.560365082,0.412524851,0.147840231
California,6017,El Dorado County,60259,50532,113446,9727,0.531169014,0.445427781,0.085741234
California,6019,Fresno County,146741,170694,323722,-23953,0.453293258,0.527285758,-0.0739925
California,6021,Glenn County,6139,3315,9639,2824,0.636891794,0.343915344,0.29297645
California,6023,Humboldt County,13756,31010,46222,-17254,0.2976072,0.670892649,-0.373285448
California,6025,Imperial County,10300,25109,36084,-14809,0.285445073,0.695848576,-0.410403503
California,6027,Inyo County,4436,4495,9147,-59,0.484967749,0.491417951,-0.006450202
California,6029,Kern County,71254,69278,143486,1976,0.496592002,0.482820624,0.013771378
California,6031,Kings County,23169,17729,41935,5440,0.552497913,0.42277334,0.129724574
California,6033,Lake County,3955,6874,11038,-2919,0.358307664,0.622757746,-0.264450082
California,6035,Lassen County,7722,2596,10484,5126,0.736550935,0.247615414,0.488935521
California,6037,Los Angeles County,984383,2609329,3674850,-1624946,0.267870253,0.710050478,-0.442180225
California,6039,Madera County,28133,22158,51405,5975,0.547281393,0.431047563,0.116233829
California,6041,Marin County,20505,112921,135667,-92416,0.151142135,0.832339478,-0.681197343
California,6043,Mariposa County,5921,4056,10215,1865,0.579637788,0.397063142,0.182574645
California,6045,Mendocino County,6312,18303,25171,-11991,0.250764769,0.727146319,-0.47638155
California,6047,Merced County,28491,36676,66575,-8185,0.427953436,0.550897484,-0.122944048
California,6049,Modoc County,2675,1063,3805,1612,0.703022339,0.279369251,0.423653088
California,6051,Mono County,2433,3884,6511,-1451,0.373675319,0.596528951,-0.222853632
California,6053,Monterey County,34893,93874,131444,-58981,0.265459055,0.714174858,-0.448715803
California,6055,Napa County,11368,32228,44383,-20860,0.256134105,0.72613388,-0.469999775
California,6057,Nevada County,15716,23593,40116,-7877,0.391763885,0.588119454,-0.196355569
California,6059,Orange County,630094,761290,1418956,-131196,0.444054643,0.53651417,-0.092459527
California,6061,Placer County,91472,89924,185153,1548,0.494034663,0.48567401,0.008360653
California,6063,Plumas County,6247,4465,10950,1782,0.570502283,0.407762557,0.162739726
California,6065,Riverside County,223443,281657,513358,-58214,0.435257656,0.548656104,-0.113398447
California,6067,Sacramento County,151776,287507,448524,-135731,0.338389919,0.641006947,-0.302617028
California,6069,San Benito County,9242,15539,25290,-6297,0.365440886,0.614432582,-0.248991696
California,6071,San Bernardino County,243419,320057,574585,-76638,0.423643151,0.557022895,-0.133379744
California,6073,San Diego County,519950,856502,1405839,-336552,0.369850317,0.609246151,-0.239395834
California,6075,San Francisco County,46296,325099,378512,-278803,0.122310521,0.858886905,-0.736576383
California,6077,San Joaquin County,59346,93016,155165,-33670,0.382470274,0.599465086,-0.216994812
California,6079,San Luis Obispo County,53438,76398,132646,-22960,0.402861752,0.575954043,-0.173092291
California,6081,San Mateo County,54456,225185,284272,-170729,0.19156301,0.792146254,-0.600583244
California,6083,Santa Barbara County,47471,103902,154830,-56431,0.306600788,0.671071498,-0.36447071
California,6085,Santa Clara County,154515,478155,644534,-323640,0.239731341,0.741861562,-0.502130221
California,6087,Santa Cruz County,25485,109745,138638,-84260,0.18382406,0.791593935,-0.607769876
California,6089,Shasta County,57894,28889,88761,29005,0.652245919,0.325469519,0.3267764
California,6091,Sierra County,1138,730,1926,408,0.59086189,0.379023884,0.211838006
California,6093,Siskiyou County,12916,9379,22836,3537,0.565598178,0.410711158,0.15488702
California,6095,Solano County,65558,124752,194829,-59194,0.336489948,0.640315353,-0.303825406
California,6097,Sonoma County,40478,153342,197603,-112864,0.204845068,0.776010486,-0.571165418
California,6099,Stanislaus County,79622,84668,168279,-5046,0.473154701,0.503140618,-0.029985916
California,6101,Sutter County,20038,15207,35969,4831,0.557090828,0.422780728,0.1343101
California,6103,Tehama County,13835,7241,21525,6594,0.642740999,0.336399535,0.306341463
California,6105,Trinity County,2513,2383,5095,130,0.493228656,0.467713445,0.025515211
California,6107,Tulare County,65454,56159,124214,9295,0.526945433,0.452114898,0.074830534
California,6109,Tuolumne County,17302,11808,29820,5494,0.580214621,0.395975855,0.184238766
California,6111,Ventura County,135555,216447,358813,-80892,0.377787315,0.603230652,-0.225443337
California,6113,Yolo County,16128,47504,64934,-31376,0.248375273,0.731573598,-0.483198324
California,6115,Yuba County,10574,7800,18820,2774,0.561849097,0.41445271,0.147396387
Colorado,8001,Adams County,94874,132951,234599,-38077,0.404409226,0.566715971,-0.162306745
Colorado,8003,Alamosa County,3676,3624,7519,52,0.4888948,0.481978987,0.006915813
Colorado,8005,Arapahoe County,126124,211498,346740,-85374,0.363742285,0.609961354,-0.246219069
Colorado,8007,Archuleta County,5126,3693,9030,1433,0.567663344,0.4089701,0.158693245
Colorado,8009,Baca County,1840,313,2193,1527,0.839033288,0.142726858,0.69630643
Colorado,8011,Bent County,1468,723,2229,745,0.658591297,0.3243607,0.334230597
Colorado,8013,Boulder County,39289,150247,193709,-110958,0.202824856,0.775632521,-0.572807665
Colorado,8014,Broomfield County,16188,28871,46297,-12683,0.349655485,0.623604121,-0.273948636
Colorado,8015,Chaffee County,6180,7112,13620,-932,0.453744493,0.522173275,-0.068428781
Colorado,8017,Cheyenne County,966,127,1105,839,0.874208145,0.114932127,0.759276018
Colorado,8019,Clear Creek County,2618,3495,6290,-877,0.416216216,0.555643879,-0.139427663
Colorado,8021,Conejos County,2269,1936,4291,333,0.52878117,0.451176882,0.077604288
Colorado,8023,Costilla County,713,1279,2031,-566,0.351058592,0.629739045,-0.278680453
Colorado,8025,Crowley County,1262,427,1730,835,0.729479769,0.246820809,0.48265896
Colorado,8027,Custer County,2433,1104,3586,1329,0.678471835,0.307863915,0.37060792
Colorado,8029,Delta County,13013,5862,19272,7151,0.675228311,0.304171856,0.371056455
Colorado,8031,Denver County,59610,283816,350606,-224206,0.170019908,0.809501264,-0.639481355
Colorado,8033,Dolores County,1080,332,1431,748,0.754716981,0.23200559,0.522711391
Colorado,8035,Douglas County,120661,104199,230478,16462,0.523525022,0.45209955,0.071425472
Colorado,8037,Eagle County,9685,18095,28427,-8410,0.340697224,0.636542723,-0.295845499
Colorado,8039,Elbert County,13722,4395,18554,9327,0.739570982,0.236876145,0.502694837
Colorado,8041,El Paso County,200968,160265,375058,40703,0.535831791,0.427307243,0.108524548
Colorado,8043,Fremont County,17231,7170,25058,10061,0.687644664,0.286136164,0.4015085
Colorado,8045,Garfield County,14404,15070,30274,-666,0.475787805,0.49778688,-0.021999075
Colorado,8047,Gilpin County,1815,2199,4143,-384,0.438088342,0.530774801,-0.092686459
Colorado,8049,Grand County,4759,4579,9606,180,0.495419529,0.476681241,0.018738289
Colorado,8051,Gunnison County,3599,6976,10887,-3377,0.330577753,0.640764214,-0.310186461
Colorado,8053,Hinsdale County,353,255,632,98,0.558544304,0.403481013,0.155063291
Colorado,8055,Huerfano County,2193,2071,4389,122,0.499658237,0.471861472,0.027796765
Colorado,8057,Jackson County,680,173,873,507,0.778923253,0.198167239,0.580756014
Colorado,8059,Jefferson County,148043,217891,376430,-69848,0.393281619,0.578835374,-0.185553755
Colorado,8061,Kiowa County,795,98,902,697,0.881374723,0.10864745,0.772727273
Colorado,8063,Kit Carson County,3084,644,3792,2440,0.813291139,0.169831224,0.643459916
Colorado,8065,Lake County,1492,2287,3938,-795,0.378872524,0.580751651,-0.201879126
Colorado,8067,La Plata County,14146,20363,35377,-6217,0.399864319,0.575599966,-0.175735647
Colorado,8069,Larimer County,91197,125765,223653,-34568,0.40776113,0.56232199,-0.15456086
Colorado,8071,Las Animas County,4255,3465,7897,790,0.538812207,0.438774218,0.100037989
Colorado,8073,Lincoln County,2118,467,2630,1651,0.805323194,0.17756654,0.627756654
Colorado,8075,Logan County,7987,2201,10411,5786,0.76716934,0.211411008,0.555758333
Colorado,8077,Mesa County,53344,30106,85368,23238,0.624871146,0.352661419,0.272209727
Colorado,8079,Mineral County,425,317,754,108,0.563660477,0.420424403,0.143236074
Colorado,8081,Moffat County,5627,1186,6964,4441,0.808012636,0.170304423,0.637708214
Colorado,8083,Montezuma County,9267,5802,15421,3465,0.600933792,0.376240192,0.2246936
Colorado,8085,Montrose County,16658,7648,24764,9010,0.672670005,0.308835406,0.363834599
Colorado,8087,Morgan County,9407,3741,13415,5666,0.701229966,0.27886694,0.422363026
Colorado,8089,Otero County,5696,3552,9459,2144,0.60217782,0.375515382,0.226662438
Colorado,8091,Ouray County,1547,2341,3960,-794,0.390656566,0.591161616,-0.200505051
Colorado,8093,Park County,6864,4786,12032,2078,0.570478723,0.397772606,0.172706117
Colorado,8095,Phillips County,1945,477,2461,1468,0.790329134,0.193823649,0.596505486
Colorado,8097,Pitkin County,2739,8906,11829,-6167,0.231549582,0.752895426,-0.521345845
Colorado,8099,Prowers County,3977,1438,5507,2539,0.722171781,0.261122208,0.461049573
Colorado,8101,Pueblo County,41502,43070,86761,-1568,0.478348567,0.496421203,-0.018072636
Colorado,8103,Rio Blanco County,3047,557,3672,2490,0.829793028,0.151688453,0.678104575
Colorado,8105,Rio Grande County,3645,2488,6280,1157,0.580414013,0.396178344,0.184235669
Colorado,8107,Routt County,5883,10523,16767,-4640,0.350867776,0.627601837,-0.276734061
Colorado,8109,Saguache County,1389,1857,3337,-468,0.416242134,0.556487863,-0.14024573
Colorado,8111,San Juan County,202,342,563,-140,0.358792185,0.607460036,-0.248667851
Colorado,8113,San Miguel County,1081,3890,5057,-2809,0.213763101,0.769230769,-0.555467669
Colorado,8115,Sedgwick County,1120,297,1441,823,0.777238029,0.20610687,0.571131159
Colorado,8117,Summit County,5275,12535,18330,-7260,0.287779596,0.683851609,-0.396072013
Colorado,8119,Teller County,11158,5224,16793,5934,0.664443518,0.311081998,0.35336152
Colorado,8121,Washington County,2537,363,2943,2174,0.862045532,0.123343527,0.738702005
Colorado,8123,Weld County,94965,65169,164791,29796,0.576275403,0.395464558,0.180810845
Colorado,8125,Yuma County,4037,763,4885,3274,0.826407369,0.156192426,0.670214944
Connecticut,9001,Fairfield County,165734,288458,460639,-122724,0.359791507,0.626212718,-0.266421211
Connecticut,9003,Hartford County,157872,279387,444223,-121515,0.355389073,0.628934116,-0.273545044
Connecticut,9005,Litchfield County,55618,50138,107541,5480,0.517179494,0.466222185,0.050957309
Connecticut,9007,Middlesex County,40472,56404,98549,-15932,0.410678952,0.572344722,-0.16166577
Connecticut,9009,New Haven County,158068,234322,397744,-76254,0.3974114,0.58912768,-0.19171628
Connecticut,9011,New London County,57071,79395,139493,-22324,0.409131641,0.569168345,-0.160036704
Connecticut,9013,Tolland County,34819,44002,80542,-9183,0.432308609,0.546323657,-0.114015048
Connecticut,9015,Windham County,29193,26721,57151,2472,0.51080471,0.467550874,0.043253836
Delaware,10001,Kent County,40976,44518,86958,-3542,0.471215989,0.511948297,-0.040732308
Delaware,10003,New Castle County,87685,194238,286133,-106553,0.3064484,0.678838163,-0.372389763
Delaware,10005,Sussex County,71196,56657,129293,14539,0.550656261,0.438206245,0.112450017
District of Columbia,11001,District of Columbia,1149,29509,31260,-28360,0.036756238,0.943985925,-0.907229687
Florida,12001,Alachua County,50891,89527,142784,-38636,0.356419487,0.627010029,-0.270590542
Florida,12003,Baker County,11911,2037,14082,9874,0.845831558,0.144652748,0.70117881
Florida,12005,Bay County,65993,25538,93025,40455,0.709411449,0.274528353,0.434883096
Florida,12007,Bradford County,10334,3160,13650,7174,0.757069597,0.231501832,0.525567766
Florida,12009,Brevard County,207857,148479,360666,59378,0.576314374,0.411680059,0.164634315
Florida,12011,Broward County,333346,618597,957388,-285251,0.348182764,0.646129887,-0.297947123
Florida,12013,Calhoun County,5269,1206,6529,4063,0.807014857,0.184714351,0.622300505
Florida,12015,Charlotte County,73202,42240,116481,30962,0.628445841,0.362634249,0.265811592
Florida,12017,Citrus County,65230,27049,93223,38181,0.699720026,0.290153717,0.409566309
Florida,12019,Clay County,84422,38248,124522,46174,0.677968552,0.307158574,0.370809977
Florida,12021,Collier County,128936,77595,208238,51341,0.619176135,0.372626514,0.246549621
Florida,12023,Columbia County,23835,8912,33039,14923,0.72142014,0.26974182,0.45167832
Florida,12027,DeSoto County,8313,4259,12676,4054,0.655806248,0.335989271,0.319816977
Florida,12029,Dixie County,6757,1364,8170,5393,0.827050184,0.166952264,0.660097919
Florida,12031,Duval County,233687,252450,492556,-18763,0.474437424,0.512530555,-0.038093131
Florida,12033,Escambia County,96655,70893,170311,25762,0.567520595,0.416256143,0.151264452
Florida,12035,Flagler County,42991,28124,71773,14867,0.598985691,0.391846516,0.207139175
Florida,12037,Franklin County,4675,2118,6857,2557,0.681785037,0.308881435,0.372903602
Florida,12039,Gadsden County,7461,16139,23783,-8678,0.313711475,0.678593954,-0.364882479
Florida,12041,Gilchrist County,7895,1700,9685,6195,0.81517811,0.175529169,0.639648942
Florida,12043,Glades County,3781,1384,5201,2397,0.726975582,0.266102673,0.460872909
Florida,12045,Gulf County,6111,1985,8170,4126,0.747980416,0.242962056,0.50501836
Florida,12047,Hamilton County,3811,1959,5832,1852,0.653463649,0.33590535,0.317558299
Florida,12049,Hardee County,6122,2298,8493,3824,0.720828918,0.270575768,0.45025315
Florida,12051,Hendry County,7898,4925,12944,2973,0.610166873,0.380485167,0.229681706
Florida,12053,Hernando County,70321,37446,109176,32875,0.644106763,0.34298747,0.301119294
Florida,12055,Highlands County,34846,16917,52193,17929,0.667637423,0.324123925,0.343513498
Florida,12057,Hillsborough County,327306,376196,713785,-48890,0.458549843,0.527043858,-0.068494014
Florida,12059,Holmes County,8074,924,9072,7150,0.889991182,0.101851852,0.78813933
Florida,12061,Indian River County,58797,37801,97619,20996,0.602311026,0.387229945,0.215081081
Florida,12063,Jackson County,15488,6766,22419,8722,0.690842589,0.301797582,0.389045006
Florida,12065,Jefferson County,4474,3893,8459,581,0.528904126,0.460219884,0.068684242
Florida,12067,Lafayette County,3126,507,3657,2619,0.854799016,0.138638228,0.716160788
Florida,12069,Lake County,125687,83273,211314,42414,0.594787851,0.394072328,0.200715523
Florida,12071,Lee County,233242,157672,394687,75570,0.590954351,0.399486175,0.191468176
Florida,12073,Leon County,57446,103492,162895,-46046,0.352656619,0.635329507,-0.282672887
Florida,12075,Levy County,16721,6189,23140,10532,0.722601556,0.267458946,0.45514261
Florida,12077,Liberty County,2846,693,3562,2153,0.798989332,0.194553622,0.60443571
Florida,12079,Madison County,5576,3747,9380,1829,0.59445629,0.399466951,0.194989339
Florida,12081,Manatee County,124966,90127,217387,34839,0.574854982,0.414592409,0.160262573
Florida,12083,Marion County,127744,74802,204577,52942,0.624429921,0.365642277,0.258787645
Florida,12085,Martin County,61133,36873,98887,24260,0.618210685,0.372880156,0.245330529
Florida,12086,Miami-Dade County,532734,617647,1158600,-84913,0.459808389,0.533097704,-0.073289315
Florida,12087,Monroe County,25668,21848,48074,3820,0.533926863,0.454466032,0.079460831
Florida,12089,Nassau County,42502,15542,58828,26960,0.722479092,0.264193921,0.45828517
Florida,12091,Okaloosa County,79633,34165,116485,45468,0.683633086,0.293299566,0.390333519
Florida,12093,Okeechobee County,11460,4380,15964,7080,0.717865197,0.274367326,0.44349787
Florida,12095,Orange County,245325,394857,648829,-149532,0.378104246,0.608568668,-0.230464421
Florida,12097,Osceola County,73467,97278,172999,-23811,0.424667195,0.562303828,-0.137636634
Florida,12099,Palm Beach County,334642,433392,774243,-98750,0.432218309,0.559762245,-0.127543936
Florida,12101,Pasco County,179545,118918,301734,60627,0.595043979,0.394115347,0.200928633
Florida,12103,Pinellas County,275949,277191,560668,-1242,0.492178972,0.494394187,-0.002215215
Florida,12105,Polk County,194271,144775,343423,49496,0.565690126,0.421564659,0.144125466
Florida,12107,Putnam County,25496,10512,36384,14984,0.700747581,0.288918206,0.411829376
Florida,12109,St. Johns County,110886,63808,176942,47078,0.626679929,0.360615343,0.266064586
Florida,12111,St. Lucie County,86825,84115,172320,2710,0.503859099,0.488132544,0.015726555
Florida,12113,Santa Rosa County,77349,27582,106857,49767,0.723855246,0.258120666,0.46573458
Florida,12115,Sarasota County,148065,119892,270656,28173,0.547059736,0.442968196,0.104091541
Florida,12117,Seminole County,125217,132486,261458,-7269,0.47891822,0.506720009,-0.027801788
Florida,12119,Sumter County,62753,29326,92600,33427,0.677678186,0.316695464,0.360982721
Florida,12121,Suwannee County,16410,4485,21082,11925,0.778389147,0.212740727,0.56564842
Florida,12123,Taylor County,7748,2299,10135,5449,0.764479526,0.226837691,0.537641835
Florida,12125,Union County,5130,1052,6247,4078,0.821194173,0.168400832,0.652793341
Florida,12127,Volusia County,173797,130541,307981,43256,0.564310785,0.423860563,0.140450223
Florida,12129,Wakulla County,12868,5346,18435,7522,0.698020071,0.289991863,0.408028207
Florida,12131,Walton County,32942,10336,43704,22606,0.753752517,0.236500092,0.517252425
Florida,12133,Washington County,9876,2347,12335,7529,0.800648561,0.190271585,0.610376976
Georgia,13001,Appling County,6526,1779,8341,4747,0.782400192,0.213283779,0.569116413
Georgia,13003,Atkinson County,2300,825,3155,1475,0.729001585,0.261489699,0.467511886
Georgia,13005,Bacon County,4018,625,4668,3393,0.86075407,0.133890317,0.726863753
Georgia,13007,Baker County,897,652,1555,245,0.576848875,0.419292605,0.15755627
Georgia,13009,Baldwin County,8903,9140,18251,-237,0.487808887,0.500794477,-0.01298559
Georgia,13011,Banks County,7795,932,8813,6863,0.884488823,0.105752865,0.778735958
Georgia,13013,Barrow County,26804,10453,38017,16351,0.705053003,0.274955941,0.430097062
Georgia,13015,Bartow County,37673,12091,50466,25582,0.746502596,0.239587049,0.506915547
Georgia,13017,Ben Hill County,4110,2392,6560,1718,0.62652439,0.364634146,0.261890244
Georgia,13019,Berrien County,6409,1268,7731,5141,0.829000129,0.164015005,0.664985125
Georgia,13021,Bibb County,26506,43234,70623,-16728,0.375316823,0.612180168,-0.236863345
Georgia,13023,Bleckley County,4328,1311,5706,3017,0.758499825,0.229758149,0.528741675
Georgia,13025,Brantley County,6991,699,7746,6292,0.902530338,0.090240124,0.812290214
Georgia,13027,Brooks County,4260,2790,7100,1470,0.6,0.392957746,0.207042254
Georgia,13029,Bryan County,14244,6739,21340,7505,0.667478913,0.31579194,0.351686973
Georgia,13031,Bulloch County,18386,11243,30084,7143,0.611155431,0.37372025,0.237435181
Georgia,13033,Burke County,5400,5209,10684,191,0.505428678,0.487551479,0.0178772
Georgia,13035,Butts County,8403,3271,11786,5132,0.712964534,0.277532666,0.435431868
Georgia,13037,Calhoun County,923,1259,2193,-336,0.420884633,0.574099407,-0.153214774
Georgia,13039,Camden County,15251,7967,23688,7284,0.643828099,0.336330632,0.307497467
Georgia,13043,Candler County,3129,1258,4420,1871,0.707918552,0.284615385,0.423303167
Georgia,13045,Carroll County,37476,16238,54474,21238,0.687961229,0.298087161,0.389874068
Georgia,13047,Catoosa County,25167,6932,32692,18235,0.769821363,0.212039643,0.55778172
Georgia,13049,Charlton County,3419,1102,4565,2317,0.748959474,0.241401972,0.507557503
Georgia,13051,Chatham County,53191,78181,133289,-24990,0.399065189,0.586552529,-0.18748734
Georgia,13053,Chattahoochee County,880,667,1590,213,0.553459119,0.419496855,0.133962264
Georgia,13055,Chattooga County,8064,1854,10050,6210,0.80238806,0.184477612,0.617910448
Georgia,13057,Cherokee County,99474,42683,144598,56791,0.687934826,0.295183889,0.392750937
Georgia,13059,Clarke County,14412,35969,51218,-21557,0.28138545,0.702272639,-0.420887188
Georgia,13061,Clay County,637,790,1434,-153,0.444211994,0.550906555,-0.106694561
Georgia,13063,Clayton County,15671,94365,111077,-78694,0.141082312,0.849545811,-0.708463498
Georgia,13065,Clinch County,2105,747,2864,1358,0.734986034,0.260824022,0.474162011
Georgia,13067,Cobb County,164965,221234,392614,-56269,0.420170957,0.56348984,-0.143318883
Georgia,13069,Coffee County,10532,4463,15142,6069,0.695548805,0.294743099,0.400805706
Georgia,13071,Colquitt County,11776,4185,16080,7591,0.732338308,0.260261194,0.472077114
Georgia,13073,Columbia County,49952,29175,80454,20777,0.620876526,0.362629577,0.258246949
Georgia,13075,Cook County,4900,2059,7035,2841,0.696517413,0.29267946,0.403837953
Georgia,13077,Coweta County,51501,24210,76799,27291,0.670594669,0.31523848,0.35535619
Georgia,13079,Crawford County,4428,1615,6102,2813,0.725663717,0.264667322,0.460996395
Georgia,13081,Crisp County,4987,2986,8052,2001,0.61934923,0.370839543,0.248509687
Georgia,13083,Dade County,6066,1261,7434,4805,0.81598063,0.169626043,0.646354587
Georgia,13085,Dawson County,13393,2486,16075,10907,0.833157076,0.154650078,0.678506998
Georgia,13087,Decatur County,6758,4780,11627,1978,0.581233336,0.411112067,0.170121269
Georgia,13089,DeKalb County,57993,305197,367359,-247204,0.15786465,0.830786778,-0.672922128
Georgia,13091,Dodge County,5839,2170,8064,3669,0.724082341,0.269097222,0.454985119
Georgia,13093,Dooly County,2159,1911,4105,248,0.525943971,0.465529842,0.060414129
Georgia,13095,Dougherty County,10446,24540,35266,-14094,0.296205977,0.695854364,-0.399648387
Georgia,13097,Douglas County,25308,42609,68745,-17301,0.368143138,0.61981235,-0.251669212
Georgia,13099,Early County,2719,2437,5184,282,0.524498457,0.470100309,0.054398148
Georgia,13101,Echols County,1256,167,1441,1089,0.871616933,0.115891742,0.755725191
Georgia,13103,Effingham County,23357,7720,31624,15637,0.738584619,0.244118391,0.494466228
Georgia,13105,Elbert County,6226,2879,9171,3347,0.678879075,0.313924327,0.364954749
Georgia,13107,Emanuel County,6551,2884,9501,3667,0.689506368,0.303546995,0.385959373
Georgia,13109,Evans County,2888,1324,4247,1564,0.680009418,0.31174947,0.368259948
Georgia,13111,Fannin County,12144,2571,14825,9573,0.81915683,0.173423272,0.645733558
Georgia,13113,Fayette County,36316,31863,69110,4453,0.525481117,0.461047605,0.064433512
Georgia,13115,Floyd County,27059,10959,38514,16100,0.702575687,0.284545879,0.418029807
Georgia,13117,Forsyth County,85081,42177,129237,42904,0.65833314,0.326353908,0.331979232
Georgia,13119,Franklin County,9069,1593,10786,7476,0.840812164,0.147691452,0.693120712
Georgia,13121,Fulton County,136140,377484,519804,-241344,0.261906411,0.726204492,-0.464298082
Georgia,13123,Gilmer County,13382,2905,16450,10477,0.813495441,0.176595745,0.636899696
Georgia,13125,Glascock County,1403,155,1566,1248,0.895913155,0.098978289,0.796934866
Georgia,13127,Glynn County,25616,15879,41984,9737,0.610137195,0.378215511,0.231921684
Georgia,13129,Gordon County,19405,4384,24033,15021,0.807431448,0.182415845,0.625015604
Georgia,13131,Grady County,7027,3608,10689,3419,0.657404809,0.337543269,0.31986154
Georgia,13133,Greene County,7068,4088,11250,2980,0.628266667,0.363377778,0.264888889
Georgia,13135,Gwinnett County,166016,241140,412757,-75124,0.40221244,0.584217833,-0.182005393
Georgia,13137,Habersham County,16616,3559,20407,13057,0.814230411,0.174400941,0.63982947
Georgia,13139,Hall County,64105,25002,90424,39103,0.708937893,0.27649739,0.432440503
Georgia,13141,Hancock County,1159,2985,4165,-1826,0.278271309,0.716686675,-0.438415366
Georgia,13143,Haralson County,12331,1792,14272,10539,0.863999439,0.125560538,0.738438901
Georgia,13145,Harris County,14319,5457,20040,8862,0.714520958,0.272305389,0.442215569
Georgia,13147,Hart County,9464,3157,12727,6307,0.743615935,0.248055315,0.495560619
Georgia,13149,Heard County,4516,824,5397,3692,0.836761164,0.152677413,0.68408375
Georgia,13151,Henry County,48187,73276,122742,-25089,0.392587704,0.596992065,-0.20440436
Georgia,13153,Houston County,41534,32232,74947,9302,0.554178286,0.430063912,0.124114374
Georgia,13155,Irwin County,3134,1008,4171,2126,0.751378566,0.241668665,0.509709902
Georgia,13157,Jackson County,29497,7642,37670,21855,0.783036899,0.202867003,0.580169896
Georgia,13159,Jasper County,5822,1761,7644,4061,0.761643119,0.230376766,0.531266353
Georgia,13161,Jeff Davis County,4695,1028,5774,3667,0.813127814,0.178039487,0.635088327
Georgia,13163,Jefferson County,3537,4061,7652,-524,0.462232096,0.530710925,-0.068478829
Georgia,13165,Jenkins County,2161,1266,3455,895,0.625470333,0.36642547,0.259044863
Georgia,13167,Johnson County,2850,1222,4100,1628,0.695121951,0.29804878,0.397073171
Georgia,13169,Jones County,9965,4888,14966,5077,0.665842577,0.326606976,0.339235601
Georgia,13171,Lamar County,6322,2612,9045,3710,0.698949696,0.288778331,0.410171365
Georgia,13173,Lanier County,2509,1019,3576,1490,0.701621924,0.284955257,0.416666667
Georgia,13175,Laurens County,14479,8048,22690,6431,0.638122521,0.354693698,0.283428823
Georgia,13177,Lee County,12007,4558,16714,7449,0.718379801,0.272705516,0.445674285
Georgia,13179,Liberty County,7944,13051,21326,-5107,0.372503048,0.611975992,-0.239472944
Georgia,13181,Lincoln County,3175,1432,4643,1743,0.683825113,0.308421279,0.375403834
Georgia,13183,Long County,3528,2033,5656,1495,0.623762376,0.359441301,0.264321075
Georgia,13185,Lowndes County,25691,20117,46355,5574,0.554222845,0.433976917,0.120245928
Georgia,13187,Lumpkin County,12160,3122,15524,9038,0.783303272,0.201107962,0.58219531
Georgia,13189,McDuffie County,6169,4168,10456,2001,0.589996174,0.3986228,0.191373374
Georgia,13191,McIntosh County,4016,2612,6700,1404,0.599402985,0.389850746,0.209552239
Georgia,13193,Macon County,1783,2857,4662,-1074,0.382453882,0.612827113,-0.23037323
Georgia,13195,Madison County,11146,3365,14707,7781,0.757870402,0.228802611,0.529067791
Georgia,13197,Marion County,2275,1311,3624,964,0.627759382,0.361754967,0.266004415
Georgia,13199,Meriwether County,6524,4287,10877,2237,0.599797738,0.394134412,0.205663326
Georgia,13201,Miller County,2066,749,2835,1317,0.728747795,0.264197531,0.464550265
Georgia,13205,Mitchell County,4935,3995,8963,940,0.550596898,0.445721299,0.1048756
Georgia,13207,Monroe County,11060,4384,15592,6676,0.709338122,0.281169831,0.428168291
Georgia,13209,Montgomery County,2959,976,3962,1983,0.746845028,0.246340232,0.500504796
Georgia,13211,Morgan County,8228,3355,11705,4873,0.702947458,0.286629645,0.416317813
Georgia,13213,Murray County,12943,2302,15389,10641,0.841055299,0.149587368,0.691467932
Georgia,13215,Muscogee County,30018,49425,80516,-19407,0.372820309,0.613853147,-0.241032838
Georgia,13217,Newton County,23867,29781,54224,-5914,0.440155651,0.549221747,-0.109066096
Georgia,13219,Oconee County,16594,8160,25165,8434,0.659407908,0.324259885,0.335148023
Georgia,13221,Oglethorpe County,5591,2435,8126,3156,0.688038395,0.299655427,0.388382968
Georgia,13223,Paulding County,54460,29658,85273,24802,0.638654674,0.347800593,0.29085408
Georgia,13225,Peach County,6502,5920,12546,582,0.51825283,0.471863542,0.046389287
Georgia,13227,Pickens County,14075,2808,17116,11267,0.822329984,0.164057023,0.658272961
Georgia,13229,Pierce County,7899,1099,9047,6800,0.873107107,0.121476733,0.751630375
Georgia,13231,Pike County,9124,1503,10715,7621,0.851516566,0.140270649,0.711245917
Georgia,13233,Polk County,13589,3658,17399,9931,0.781021898,0.210241968,0.57077993
Georgia,13235,Pulaski County,2805,1217,4059,1588,0.691056911,0.299827544,0.391229367
Georgia,13237,Putnam County,8291,3448,11855,4843,0.699367356,0.290847744,0.408519612
Georgia,13239,Quitman County,604,497,1106,107,0.546112116,0.449367089,0.096745027
Georgia,13241,Rabun County,7474,1984,9587,5490,0.779597371,0.206946907,0.572650464
Georgia,13243,Randolph County,1391,1671,3074,-280,0.45250488,0.543591412,-0.091086532
Georgia,13245,Richmond County,26707,58776,86584,-32069,0.308451908,0.678832117,-0.370380209
Georgia,13247,Rockdale County,12990,31199,44617,-18209,0.291144631,0.699262613,-0.408117982
Georgia,13249,Schley County,1800,462,2275,1338,0.791208791,0.203076923,0.588131868
Georgia,13251,Screven County,3915,2661,6641,1254,0.589519651,0.400692667,0.188826984
Georgia,13253,Seminole County,2607,1251,3877,1356,0.672427134,0.322672169,0.349754965
Georgia,13255,Spalding County,18057,11784,30161,6273,0.598687046,0.390703226,0.20798382
Georgia,13257,Stephens County,9368,2385,11885,6983,0.788220446,0.200673117,0.587547329
Georgia,13259,Stewart County,801,1182,1990,-381,0.402512563,0.593969849,-0.191457286
Georgia,13261,Sumter County,5732,6318,12150,-586,0.471769547,0.52,-0.048230453
Georgia,13263,Talbot County,1390,2113,3519,-723,0.394998579,0.600454675,-0.205456095
Georgia,13265,Taliaferro County,360,561,928,-201,0.387931034,0.604525862,-0.216594828
Georgia,13267,Tattnall County,6048,2059,8175,3989,0.739816514,0.251865443,0.48795107
Georgia,13269,Taylor County,2418,1387,3839,1031,0.629851524,0.361292003,0.268559521
Georgia,13271,Telfair County,2822,1480,4323,1342,0.652787416,0.342354846,0.31043257
Georgia,13273,Terrell County,2004,2376,4417,-372,0.453701607,0.537921666,-0.084220059
Georgia,13275,Thomas County,12954,8708,21853,4246,0.592779023,0.398480758,0.194298266
Georgia,13277,Tift County,10784,5322,16284,5462,0.662245149,0.326823876,0.335421272
Georgia,13279,Toombs County,7872,2939,10914,4933,0.721275426,0.269287154,0.451988272
Georgia,13281,Towns County,6384,1550,7979,4834,0.800100263,0.194259932,0.605840331
Georgia,13283,Treutlen County,2101,952,3077,1149,0.68280793,0.309392265,0.373415665
Georgia,13285,Troup County,18097,11542,29967,6555,0.603897621,0.385157006,0.218740615
Georgia,13287,Turner County,2349,1410,3792,939,0.619462025,0.371835443,0.247626582
Georgia,13289,Twiggs County,2368,2040,4438,328,0.533573682,0.459666516,0.073907165
Georgia,13291,Union County,12651,2801,15592,9850,0.81137763,0.179643407,0.631734223
Georgia,13293,Upson County,8602,4201,12899,4401,0.666873401,0.325684162,0.341189239
Georgia,13295,Walker County,23174,5769,29436,17405,0.787267292,0.195984509,0.591282783
Georgia,13297,Walton County,37617,12634,50812,24983,0.740317248,0.248642053,0.491675195
Georgia,13299,Ware County,9930,4249,14296,5681,0.694599888,0.297216004,0.397383884
Georgia,13301,Warren County,1177,1488,2681,-311,0.439015293,0.555016785,-0.116001492
Georgia,13303,Washington County,4663,4730,9462,-67,0.492813359,0.499894314,-0.007080955
Georgia,13305,Wayne County,9987,2687,12790,7300,0.78084441,0.210086005,0.570758405
Georgia,13307,Webster County,748,639,1390,109,0.538129496,0.45971223,0.078417266
Georgia,13309,Wheeler County,1583,688,2286,895,0.692475941,0.30096238,0.391513561
Georgia,13311,White County,12222,2411,14816,9811,0.824919006,0.162729482,0.662189525
Georgia,13313,Whitfield County,25636,10670,36746,14966,0.697654166,0.290371741,0.407282425
Georgia,13315,Wilcox County,2403,862,3281,1541,0.732398659,0.262724779,0.46967388
Georgia,13317,Wilkes County,2823,2159,5029,664,0.561344204,0.429310002,0.132034202
Georgia,13319,Wilkinson County,2664,2075,4770,589,0.558490566,0.435010482,0.123480084
Georgia,13321,Worth County,6826,2395,9281,4431,0.73548109,0.258054089,0.477427001
Hawaii,15001,Hawaii County,26851,58683,87716,-31832,0.30611291,0.669011355,-0.362898445
Hawaii,15003,Honolulu County,136061,238601,381627,-102540,0.356528757,0.625220438,-0.268691681
Hawaii,15007,Kauai County,11579,21217,33486,-9638,0.345786299,0.633608075,-0.287821776
Hawaii,15009,Maui County,22111,47301,71025,-25190,0.311312918,0.665976769,-0.354663851
Idaho,16001,Ada County,130699,120539,259389,10160,0.503872562,0.464703592,0.03916897
Idaho,16003,Adams County,1941,591,2586,1350,0.750580046,0.228538283,0.522041763
Idaho,16005,Bannock County,23331,14682,39771,8649,0.586633477,0.369163461,0.217470016
Idaho,16007,Bear Lake County,2814,350,3215,2464,0.875272162,0.108864697,0.766407465
Idaho,16009,Benewah County,3878,977,4972,2901,0.77996782,0.196500402,0.583467418
Idaho,16011,Bingham County,15295,4124,20094,11171,0.761172489,0.205235394,0.555937096
Idaho,16013,Blaine County,4031,8919,13343,-4888,0.302105973,0.668440381,-0.366334408
Idaho,16015,Boise County,3495,1214,4840,2281,0.722107438,0.250826446,0.471280992
Idaho,16017,Bonner County,18369,8310,27352,10059,0.671577947,0.303816906,0.367761041
Idaho,16019,Bonneville County,37805,14254,53995,23551,0.700157422,0.263987406,0.436170016
Idaho,16021,Boundary County,4937,1220,6313,3717,0.782037066,0.19325202,0.588785047
Idaho,16023,Butte County,1202,188,1415,1014,0.849469965,0.132862191,0.716607774
Idaho,16025,Camas County,507,149,754,358,0.672413793,0.197612732,0.474801061
Idaho,16027,Canyon County,61759,25881,90438,35878,0.682887724,0.286173953,0.396713771
Idaho,16029,Caribou County,2906,431,3416,2475,0.850702576,0.12617096,0.724531616
Idaho,16031,Cassia County,7907,1464,9643,6443,0.819973037,0.151819973,0.668153064
Idaho,16033,Clark County,264,41,311,223,0.848874598,0.131832797,0.717041801
Idaho,16035,Clearwater County,3453,877,4419,2576,0.781398506,0.19846119,0.582937316
Idaho,16037,Custer County,2089,603,2737,1486,0.763244428,0.220314213,0.542930216
Idaho,16039,Elmore County,7246,2601,10205,4645,0.710044096,0.254875061,0.455169035
Idaho,16041,Franklin County,5845,657,6664,5188,0.87710084,0.098589436,0.778511405
Idaho,16043,Fremont County,5548,998,6719,4550,0.825718113,0.148534008,0.677184105
Idaho,16045,Gem County,7951,1803,9958,6148,0.798453505,0.181060454,0.617393051
Idaho,16047,Gooding County,4659,1256,6050,3403,0.770082645,0.207603306,0.562479339
Idaho,16049,Idaho County,7826,1561,9602,6265,0.815038534,0.162570298,0.652468236
Idaho,16051,Jefferson County,12099,1658,14171,10441,0.853785901,0.116999506,0.736786395
Idaho,16053,Jerome County,5734,1893,7812,3841,0.733998976,0.242319508,0.491679467
Idaho,16055,Kootenai County,62837,24312,89878,38525,0.699136607,0.270500011,0.428636596
Idaho,16057,Latah County,9463,10199,20521,-736,0.461137371,0.49700307,-0.035865699
Idaho,16059,Lemhi County,3592,1032,4738,2560,0.758125791,0.217813423,0.540312368
Idaho,16061,Lewis County,1489,349,1870,1140,0.796256684,0.186631016,0.609625668
Idaho,16063,Lincoln County,1469,414,1940,1055,0.757216495,0.213402062,0.543814433
Idaho,16065,Madison County,13559,2666,17112,10893,0.792367929,0.155797101,0.636570827
Idaho,16067,Minidoka County,6265,1550,7993,4715,0.783810834,0.19391968,0.589891155
Idaho,16069,Nez Perce County,13738,6686,20967,7052,0.655220108,0.318882053,0.336338055
Idaho,16071,Oneida County,2148,249,2451,1899,0.876376989,0.101591187,0.774785802
Idaho,16073,Owyhee County,3819,816,4742,3003,0.80535639,0.172079291,0.633277098
Idaho,16075,Payette County,8862,2161,11293,6701,0.784733906,0.191357478,0.593376428
Idaho,16077,Power County,2116,865,3086,1251,0.685677252,0.280298121,0.405379132
Idaho,16079,Shoshone County,4216,1693,6049,2523,0.696974707,0.279880972,0.417093735
Idaho,16081,Teton County,2858,3318,6347,-460,0.450291476,0.522766661,-0.072475185
Idaho,16083,Twin Falls County,25897,9391,36680,16506,0.706025082,0.256025082,0.45
Idaho,16085,Valley County,3947,2976,7063,971,0.558827694,0.421350701,0.137476993
Idaho,16087,Washington County,4154,1073,5344,3081,0.777320359,0.200785928,0.576534431
Illinois,17001,Adams County,24131,8569,33434,15562,0.721750314,0.256295986,0.465454328
Illinois,17003,Alexander County,3056,2522,5631,534,0.542709998,0.447877819,0.094832179
Illinois,17005,Bond County,5612,2275,8109,3337,0.692070539,0.280552473,0.411518066
Illinois,17007,Boone County,13762,10372,24672,3390,0.557798314,0.42039559,0.137402724
Illinois,17009,Brown County,1930,485,2523,1445,0.764962346,0.19223147,0.572730876
Illinois,17011,Bureau County,10296,6545,17182,3751,0.599231754,0.380921895,0.218309859
Illinois,17013,Calhoun County,2043,674,2767,1369,0.738344778,0.24358511,0.494759668
Illinois,17015,Carroll County,5098,2737,8006,2361,0.636772421,0.341868599,0.294903822
Illinois,17017,Cass County,3624,1615,5325,2009,0.68056338,0.303286385,0.377276995
Illinois,17019,Champaign County,34774,55173,93019,-20399,0.373837603,0.593136886,-0.219299283
Illinois,17021,Christian County,11505,4286,16094,7219,0.714862682,0.266310426,0.448552255
Illinois,17023,Clark County,6215,1990,8340,4225,0.745203837,0.238609113,0.506594724
Illinois,17025,Clay County,5626,1129,6896,4497,0.815835267,0.163718097,0.652117169
Illinois,17027,Clinton County,14264,4459,19139,9805,0.745284498,0.23297978,0.512304718
Illinois,17029,Coles County,13981,7997,22470,5984,0.622207388,0.355896751,0.266310636
Illinois,17031,Cook County,483186,1374757,1886299,-891571,0.256155572,0.728811816,-0.472656244
Illinois,17033,Crawford County,7025,2198,9419,4827,0.745832891,0.233358106,0.512474785
Illinois,17035,Cumberland County,4595,1141,5843,3454,0.78641109,0.195276399,0.591134691
Illinois,17037,DeKalb County,21818,24484,47717,-2666,0.457237463,0.513108536,-0.055871073
Illinois,17039,De Witt County,5623,2171,7994,3452,0.703402552,0.271578684,0.431823868
Illinois,17041,Douglas County,6221,2327,8746,3894,0.711296593,0.266064487,0.445232106
Illinois,17043,DuPage County,187957,269638,467186,-81681,0.402317278,0.577153425,-0.174836147
Illinois,17045,Edgar County,6169,1869,8152,4300,0.756746811,0.229268891,0.52747792
Illinois,17047,Edwards County,2833,488,3368,2345,0.841152019,0.144893112,0.696258907
Illinois,17049,Effingham County,14983,3700,19041,11283,0.786880941,0.194317525,0.592563416
Illinois,17051,Fayette County,8025,1815,10033,6210,0.79986046,0.18090302,0.61895744
Illinois,17053,Ford County,4956,1691,6809,3265,0.727860185,0.248347775,0.47951241
Illinois,17055,Franklin County,13514,4690,18488,8824,0.730960623,0.253678061,0.477282562
Illinois,17057,Fulton County,9798,6371,16517,3427,0.593206999,0.3857238,0.207483199
Illinois,17059,Gallatin County,2019,621,2673,1398,0.755331089,0.232323232,0.523007856
Illinois,17061,Greene County,4767,1349,6224,3418,0.76590617,0.216741645,0.549164524
Illinois,17063,Grundy County,16372,9445,26400,6927,0.620151515,0.357765152,0.262386364
Illinois,17065,Hamilton County,3429,821,4316,2608,0.794485635,0.190222428,0.604263207
Illinois,17067,Hancock County,5309,1114,6565,4195,0.808682407,0.169687738,0.638994669
Illinois,17069,Hardin County,28816,7048,0,0,NaN,NaN,NaN
Illinois,17071,Henderson County,2391,1186,3652,1205,0.654709748,0.32475356,0.329956188
Illinois,17073,Henry County,15266,9762,25624,5504,0.595769591,0.380970965,0.214798626
Illinois,17075,Iroquois County,10858,2895,14011,7963,0.774962529,0.206623367,0.568339162
Illinois,17077,Jackson County,10835,11104,22575,-269,0.479955703,0.491871539,-0.011915836
Illinois,17079,Jasper County,4492,1006,5582,3486,0.804729488,0.180222143,0.624507345
Illinois,17081,Jefferson County,12461,4597,17409,7864,0.715779195,0.26405882,0.451720375
Illinois,17083,Jersey County,8699,2956,11942,5743,0.728437448,0.247529727,0.480907721
Illinois,17085,Jo Daviess County,7161,5097,12477,2064,0.573936042,0.408511661,0.165424381
Illinois,17087,Johnson County,5052,1280,6442,3772,0.7842285,0.198696057,0.585532443
Illinois,17089,Kane County,96739,130069,231734,-33330,0.417457084,0.561285785,-0.1438287
Illinois,17091,Kankakee County,28410,20112,49729,8298,0.571296427,0.404432022,0.166864405
Illinois,17093,Kendall County,28515,31394,61327,-2879,0.464966491,0.511911556,-0.046945065
Illinois,17095,Knox County,11818,10421,22716,1397,0.520250044,0.458751541,0.061498503
Illinois,17097,Lake County,105416,144674,254827,-39258,0.41367673,0.567734188,-0.154057459
Illinois,17099,LaSalle County,29482,21491,52053,7991,0.566384262,0.412867654,0.153516608
Illinois,17101,Lawrence County,4849,1414,6379,3435,0.760150494,0.221664838,0.538485656
Illinois,17103,Lee County,9584,6368,16351,3216,0.58614152,0.389456302,0.196685218
Illinois,17105,Livingston County,12134,4568,17049,7566,0.711713297,0.267933603,0.443779694
Illinois,17107,Logan County,9042,3769,13117,5273,0.689334451,0.287337044,0.401997408
Illinois,17109,McDonough County,7009,4973,12290,2036,0.570301058,0.404637917,0.165663141
Illinois,17111,McHenry County,79396,73610,156805,5786,0.506335895,0.469436561,0.036899334
Illinois,17113,McLean County,40365,43719,87013,-3354,0.463896199,0.502442164,-0.038545964
Illinois,17115,Macon County,28373,19633,48934,8740,0.579821801,0.40121388,0.178607921
Illinois,17117,Macoupin County,16058,7313,23919,8745,0.671349137,0.305740207,0.36560893
Illinois,17119,Madison County,75727,56845,136141,18882,0.556239487,0.417545045,0.138694442
Illinois,17121,Marion County,12540,4396,17214,8144,0.728476821,0.255373533,0.473103288
Illinois,17123,Marshall County,4196,2004,6343,2192,0.661516633,0.31593883,0.345577802
Illinois,17125,Mason County,4645,1984,6756,2661,0.687537004,0.29366489,0.393872114
Illinois,17127,Massac County,4989,1719,6803,3270,0.733352933,0.25268264,0.480670293
Illinois,17129,Menard County,4722,2003,6889,2719,0.685440557,0.290753375,0.394687182
Illinois,17131,Mercer County,5328,3212,8750,2116,0.608914286,0.367085714,0.241828571
Illinois,17133,Monroe County,14046,6489,21024,7557,0.668093607,0.30864726,0.359446347
Illinois,17135,Montgomery County,9504,3889,13701,5615,0.693671995,0.283847894,0.4098241
Illinois,17137,Morgan County,9903,5020,15229,4883,0.650272506,0.32963425,0.320638256
Illinois,17139,Moultrie County,4938,1645,6698,3293,0.737234996,0.2455957,0.491639295
Illinois,17141,Ogle County,16092,9300,26040,6792,0.61797235,0.357142857,0.260829493
Illinois,17143,Peoria County,37612,42600,82264,-4988,0.457210931,0.517844987,-0.060634056
Illinois,17145,Perry County,7305,2609,10060,4696,0.726143141,0.259343936,0.466799205
Illinois,17147,Piatt County,6219,3302,9791,2917,0.635175161,0.337248494,0.297926667
Illinois,17149,Pike County,6235,1458,7836,4777,0.795686575,0.186064319,0.609622256
Illinois,17151,Pope County,1720,432,2172,1288,0.791896869,0.198895028,0.593001842
Illinois,17153,Pulaski County,1699,891,2631,808,0.645762068,0.338654504,0.307107564
Illinois,17155,Putnam County,1978,1309,3345,669,0.591330344,0.391330344,0.2
Illinois,17157,Randolph County,11065,3590,14896,7475,0.742816864,0.241004296,0.501812567
Illinois,17159,Richland County,7988,1355,9343,6633,0.854971637,0.145028363,0.709943273
Illinois,17161,Rock Island County,28585,36647,66750,-8062,0.4282397,0.549018727,-0.120779026
Illinois,17163,St. Clair County,56000,66698,125220,-10698,0.447212905,0.532646542,-0.085433637
Illinois,17165,Saline County,8096,2786,11079,5310,0.730751873,0.251466739,0.479285134
Illinois,17167,Sangamon County,53303,48756,104395,4547,0.510589588,0.467033862,0.043555726
Illinois,17169,Schuyler County,2767,1064,3908,1703,0.7080348,0.272262027,0.435772774
Illinois,17171,Scott County,2104,569,2730,1535,0.770695971,0.208424908,0.562271062
Illinois,17173,Shelby County,9396,2488,12049,6908,0.779815752,0.206490165,0.573325587
Illinois,17175,Stark County,2000,814,2881,1186,0.694203402,0.282540784,0.411662617
Illinois,17177,Stephenson County,12253,8756,21446,3497,0.571341975,0.408281265,0.163060711
Illinois,17179,Tazewell County,42194,24486,68358,17708,0.617250358,0.358202405,0.259047953
Illinois,17181,Union County,6157,2575,8896,3582,0.692108813,0.289455935,0.402652878
Illinois,17183,Vermilion County,20710,10313,31617,10397,0.655027359,0.32618528,0.328842079
Illinois,17185,Wabash County,4228,1248,5592,2980,0.756080114,0.223175966,0.532904149
Illinois,17187,Warren County,4671,3087,7916,1584,0.590070743,0.389969682,0.200101061
Illinois,17189,Washington County,6110,1639,7914,4471,0.772049532,0.207101339,0.564948193
Illinois,17191,Wayne County,7172,1185,8446,5987,0.849159365,0.140303102,0.708856263
Illinois,17193,White County,5788,1517,7428,4271,0.779213786,0.204227248,0.574986537
Illinois,17195,Whiteside County,14472,12195,27254,2277,0.531004623,0.447457254,0.083547369
Illinois,17197,Will County,149695,174226,330593,-24531,0.452807531,0.527010554,-0.074203023
Illinois,17199,Williamson County,22681,10107,33503,12574,0.676984151,0.301674477,0.375309674
Illinois,17201,Winnebago County,60390,58721,121684,1669,0.496285461,0.482569607,0.013715854
Illinois,17203,Woodford County,14590,5976,21079,8614,0.692158072,0.28350491,0.408653162
Indiana,18001,Adams County,10685,3236,14238,7449,0.750456525,0.227279112,0.523177413
Indiana,18003,Allen County,91885,72825,168964,19060,0.543814067,0.431008972,0.112805095
Indiana,18005,Bartholomew County,22409,12934,36299,9475,0.61734483,0.356318356,0.261026475
Indiana,18007,Benton County,3007,1009,4115,1998,0.730741191,0.245200486,0.485540705
Indiana,18009,Blackford County,3838,1376,5354,2462,0.716847217,0.257004109,0.459843108
Indiana,18011,Boone County,22351,15244,38622,7107,0.578711615,0.394697323,0.184014292
Indiana,18013,Brown County,5725,2996,8886,2729,0.644271888,0.337159577,0.307112312
Indiana,18015,Carroll County,7086,2224,9514,4862,0.744797141,0.233760774,0.511036367
Indiana,18017,Cass County,10551,4301,15185,6250,0.694830425,0.28324004,0.411590385
Indiana,18019,Clark County,33656,23088,58040,10568,0.579875948,0.397794624,0.182081323
Indiana,18021,Clay County,9498,2549,12277,6949,0.773641769,0.207624012,0.566017757
Indiana,18023,Clinton County,9334,3361,12961,5973,0.720160481,0.259316411,0.460844071
Indiana,18025,Crawford County,3499,1369,4979,2130,0.702751557,0.27495481,0.427796746
Indiana,18027,Daviess County,9576,2169,11971,7407,0.799933172,0.181187871,0.618745301
Indiana,18029,Dearborn County,19441,5433,25302,14008,0.768358233,0.214726109,0.553632124
Indiana,18031,Decatur County,9570,2436,12296,7134,0.778301887,0.198113208,0.580188679
Indiana,18033,DeKalb County,14237,4966,19656,9271,0.724308099,0.252645503,0.471662597
Indiana,18035,Delaware County,26724,20328,48089,6396,0.555719603,0.422716214,0.13300339
Indiana,18037,Dubois County,15032,6292,21805,8740,0.689383169,0.28855767,0.400825499
Indiana,18039,Elkhart County,46311,25413,73225,20898,0.632447934,0.347053602,0.285394333
Indiana,18041,Fayette County,7755,2237,10146,5518,0.764340627,0.220480978,0.543859649
Indiana,18043,Floyd County,23385,17507,41742,5878,0.560227109,0.419409707,0.140817402
Indiana,18045,Fountain County,6151,1627,7978,4524,0.770995237,0.203935824,0.567059413
Indiana,18047,Franklin County,9691,2137,12018,7554,0.806373773,0.177816608,0.628557164
Indiana,18049,Fulton County,6667,2274,9110,4393,0.73183315,0.249615807,0.482217344
Indiana,18051,Gibson County,11817,4027,16165,7790,0.731023817,0.249118466,0.481905351
Indiana,18053,Grant County,18543,8015,27230,10528,0.680976864,0.294344473,0.386632391
Indiana,18055,Greene County,11103,3389,14807,7714,0.749848045,0.228878233,0.520969812
Indiana,18057,Hamilton County,101563,88367,194447,13196,0.522317135,0.454452884,0.067864251
Indiana,18059,Hancock County,28816,12821,42645,15995,0.675718138,0.300644859,0.375073279
Indiana,18061,Harrison County,14542,5334,20198,9208,0.719972274,0.264085553,0.455886721
Indiana,18063,Hendricks County,53688,32453,88430,21235,0.607124279,0.36699084,0.240133439
Indiana,18065,Henry County,15043,5543,21020,9500,0.71565176,0.263701237,0.451950523
Indiana,18067,Howard County,26400,13270,40619,13130,0.649942145,0.326694404,0.323247741
Indiana,18069,Huntington County,13147,4254,17809,8893,0.738222247,0.238867988,0.499354259
Indiana,18071,Jackson County,14555,4302,19238,10253,0.756575528,0.223619919,0.532955609
Indiana,18073,Jasper County,11383,3798,15495,7585,0.734624072,0.245111326,0.489512746
Indiana,18075,Jay County,6361,1926,8466,4435,0.751358375,0.227498228,0.523860146
Indiana,18077,Jefferson County,9659,4732,14726,4927,0.655914709,0.321336412,0.334578297
Indiana,18079,Jennings County,9488,2521,12272,6967,0.773142112,0.205426988,0.567715124
Indiana,18081,Johnson County,51209,24729,77784,26480,0.658348761,0.317918852,0.340429908
Indiana,18083,Knox County,11654,4067,16027,7587,0.727147938,0.253759281,0.473388657
Indiana,18085,Kosciusko County,26476,8350,35846,18126,0.738604028,0.232940914,0.505663114
Indiana,18087,LaGrange County,8110,2355,10633,5755,0.762719834,0.221480297,0.541239537
Indiana,18089,Lake County,91733,124801,220233,-33068,0.416527042,0.56667711,-0.150150068
Indiana,18091,LaPorte County,25991,22419,49469,3572,0.525399745,0.453192909,0.072206837
Indiana,18093,Lawrence County,15601,4961,21071,10640,0.7404015,0.235442077,0.504959423
Indiana,18095,Madison County,31153,19459,51711,11694,0.602444354,0.376302914,0.22614144
Indiana,18097,Marion County,133902,247034,390106,-113132,0.343245169,0.633248399,-0.29000323
Indiana,18099,Marshall County,13841,5712,19934,8129,0.694341326,0.2865456,0.407795726
Indiana,18101,Martin County,4029,1011,5155,3018,0.78157129,0.196120272,0.585451018
Indiana,18103,Miami County,10925,3235,14493,7690,0.753812185,0.223211205,0.53060098
Indiana,18105,Monroe County,22062,39855,63020,-17793,0.35007934,0.63241828,-0.28233894
Indiana,18107,Montgomery County,12659,4212,17197,8447,0.736116765,0.244926441,0.491190324
Indiana,18109,Morgan County,27510,7777,36214,19733,0.759650964,0.214751201,0.544899763
Indiana,18111,Newton County,4942,1509,6606,3433,0.748107781,0.228428701,0.51967908
Indiana,18113,Noble County,14195,4660,19217,9535,0.738668887,0.242493625,0.496175261
Indiana,18115,Ohio County,2392,750,3164,1642,0.756005057,0.237041719,0.518963338
Indiana,18117,Orange County,6432,2224,8833,4208,0.728178422,0.251783086,0.476395336
Indiana,18119,Owen County,7285,2419,9915,4866,0.734745335,0.243973777,0.490771558
Indiana,18121,Parke County,5398,1503,7020,3895,0.768945869,0.214102564,0.554843305
Indiana,18123,Perry County,5343,3202,8734,2141,0.611747195,0.366613236,0.245133959
Indiana,18125,Pike County,4692,1415,6220,3277,0.754340836,0.227491961,0.526848875
Indiana,18127,Porter County,44899,39537,86284,5362,0.520362987,0.458219369,0.062143619
Indiana,18129,Posey County,9206,3811,13264,5395,0.694059107,0.287319059,0.406740048
Indiana,18131,Pulaski County,4246,1463,5813,2783,0.730431791,0.251677275,0.478754516
Indiana,18133,Putnam County,12278,3946,16595,8332,0.739861404,0.237782465,0.502078939
Indiana,18135,Randolph County,8312,2512,11078,5800,0.750315942,0.226755732,0.523560209
Indiana,18137,Ripley County,11261,2774,14280,8487,0.788585434,0.194257703,0.594327731
Indiana,18139,Rush County,6035,1754,7938,4281,0.76026707,0.220962459,0.539304611
Indiana,18141,St. Joseph County,53152,59870,115547,-6718,0.460003289,0.518144132,-0.058140843
Indiana,18143,Scott County,7328,2698,10176,4630,0.720125786,0.265133648,0.454992138
Indiana,18145,Shelby County,14568,5023,20017,9545,0.727781386,0.250936704,0.476844682
Indiana,18147,Spencer County,7354,3208,10781,4146,0.682125962,0.297560523,0.384565439
Indiana,18149,Starke County,7466,2650,10309,4816,0.724221554,0.257056941,0.467164613
Indiana,18151,Steuben County,11322,4509,16175,6813,0.699969088,0.278763524,0.421205564
Indiana,18153,Sullivan County,6687,2153,9004,4534,0.742669924,0.239115948,0.503553976
Indiana,18155,Switzerland County,3133,964,4152,2169,0.754576108,0.232177264,0.522398844
Indiana,18157,Tippecanoe County,34571,34993,71755,-422,0.48179221,0.487673333,-0.005881123
Indiana,18159,Tipton County,6110,1834,8124,4276,0.752092565,0.225750862,0.526341704
Indiana,18161,Union County,2687,736,3491,1951,0.769693498,0.210827843,0.558865655
Indiana,18163,Vanderburgh County,41838,34404,77563,7434,0.539406676,0.443562008,0.095844668
Indiana,18165,Vermillion County,5184,2145,7490,3039,0.69212283,0.286381842,0.405740988
Indiana,18167,Vigo County,24512,18080,43593,6432,0.562292111,0.414745487,0.147546624
Indiana,18169,Wabash County,10762,3494,14598,7268,0.737224277,0.239347856,0.497876421
Indiana,18171,Warren County,3401,974,4473,2427,0.760339817,0.21775095,0.542588867
Indiana,18173,Warrick County,21324,11919,33884,9405,0.629323575,0.351758942,0.277564632
Indiana,18175,Washington County,9112,2783,12126,6329,0.75144318,0.229506845,0.521936335
Indiana,18177,Wayne County,17567,9524,27662,8043,0.635058926,0.344299038,0.290759887
Indiana,18179,Wells County,10855,2928,14080,7927,0.770951705,0.207954545,0.562997159
Indiana,18181,White County,7353,2868,10402,4485,0.706883292,0.275716208,0.431167083
Indiana,18183,Whitley County,12856,4233,17581,8623,0.731243957,0.240771287,0.490472669
Iowa,19001,Adair County,2917,1197,4183,1720,0.697346402,0.28615826,0.411188142
Iowa,19003,Adams County,1528,590,2158,938,0.708063021,0.273401297,0.434661724
Iowa,19005,Allamakee County,4733,2575,7459,2158,0.634535461,0.345220539,0.289314922
Iowa,19007,Appanoose County,4508,1889,6500,2619,0.693538462,0.290615385,0.402923077
Iowa,19009,Audubon County,2292,1071,3413,1221,0.671549956,0.313800176,0.35774978
Iowa,19011,Benton County,9179,5156,14627,4023,0.627538114,0.352498804,0.275039311
Iowa,19013,Black Hawk County,29623,35621,66549,-5998,0.445130656,0.535259733,-0.090129078
Iowa,19015,Boone County,8676,6293,15277,2383,0.567912548,0.411926425,0.155986123
Iowa,19017,Bremer County,8287,5954,14534,2333,0.570180267,0.409660107,0.16052016
Iowa,19019,Buchanan County,6418,4167,10759,2251,0.596523841,0.387303653,0.209220188
Iowa,19021,Buena Vista County,5004,2919,8072,2085,0.619920714,0.361620416,0.258300297
Iowa,19023,Butler County,5540,2423,8081,3117,0.685558718,0.299839129,0.385719589
Iowa,19025,Calhoun County,3687,1469,5246,2218,0.702821197,0.280022875,0.422798323
Iowa,19027,Carroll County,7720,3444,11277,4276,0.684579232,0.305400372,0.37917886
Iowa,19029,Cass County,4969,2201,7266,2768,0.68387008,0.302917699,0.380952381
Iowa,19031,Cedar County,6161,4336,10702,1825,0.575686788,0.405157914,0.170528873
Iowa,19033,Cerro Gordo County,12435,10941,23794,1494,0.522610742,0.459821804,0.062788938
Iowa,19035,Cherokee County,4495,1936,6503,2559,0.691219437,0.29770875,0.393510687
Iowa,19037,Chickasaw County,4299,2230,6605,2069,0.650870553,0.337623013,0.31324754
Iowa,19039,Clarke County,3140,1466,4666,1674,0.672953279,0.314187741,0.358765538
Iowa,19041,Clay County,6126,2653,8928,3473,0.686155914,0.297155018,0.389000896
Iowa,19043,Clayton County,6105,3339,9589,2766,0.636667014,0.348211492,0.288455522
Iowa,19045,Clinton County,13349,10806,24620,2543,0.542201462,0.438911454,0.103290008
Iowa,19047,Crawford County,4842,2211,7125,2631,0.679578947,0.310315789,0.369263158
Iowa,19049,Dallas County,27882,26771,55803,1111,0.499650556,0.479741233,0.019909324
Iowa,19051,Davis County,3032,1013,4099,2019,0.739692608,0.247133447,0.492559161
Iowa,19053,Decatur County,2613,1117,3798,1496,0.687993681,0.294102159,0.393891522
Iowa,19055,Delaware County,6666,3157,9981,3509,0.667868951,0.316300972,0.351567979
Iowa,19057,Des Moines County,10589,8887,19897,1702,0.532190783,0.446650249,0.085540534
Iowa,19059,Dickinson County,7432,3660,11223,3772,0.66221153,0.326116012,0.336095518
Iowa,19061,Dubuque County,27214,25655,53924,1559,0.504673244,0.475762184,0.02891106
Iowa,19063,Emmet County,3265,1520,4850,1745,0.673195876,0.313402062,0.359793814
Iowa,19065,Fayette County,6145,3834,10184,2311,0.603397486,0.376472899,0.226924588
Iowa,19067,Floyd County,4730,3168,8026,1562,0.589334662,0.394717169,0.194617493
Iowa,19069,Franklin County,3420,1625,5116,1795,0.668491009,0.317630962,0.350860047
Iowa,19071,Fremont County,2711,1078,3855,1633,0.703242542,0.279636835,0.423605707
Iowa,19073,Greene County,3221,1768,5054,1453,0.637316977,0.349821923,0.287495053
Iowa,19075,Grundy County,4911,2194,7245,2717,0.677846791,0.302829538,0.375017253
Iowa,19077,Guthrie County,4272,1985,6369,2287,0.67074894,0.311665882,0.359083059
Iowa,19079,Hamilton County,4956,2842,8516,2114,0.581963363,0.333724753,0.24823861
Iowa,19081,Hancock County,4386,1682,6164,2704,0.711550941,0.272874757,0.438676184
Iowa,19083,Hardin County,5842,2971,8962,2871,0.651863423,0.331510823,0.3203526
Iowa,19085,Harrison County,5563,2439,8137,3124,0.683667199,0.29974192,0.38392528
Iowa,19087,Henry County,6483,3264,9929,3219,0.652935844,0.328734011,0.324201833
Iowa,19089,Howard County,3126,1772,4951,1354,0.631387598,0.357907493,0.273480105
Iowa,19091,Humboldt County,3818,1442,5320,2376,0.717669173,0.271052632,0.446616541
Iowa,19093,Ida County,2876,917,3845,1959,0.747984395,0.238491547,0.509492848
Iowa,19095,Iowa County,6009,3546,9741,2463,0.616877117,0.364028334,0.252848783
Iowa,19097,Jackson County,6940,4029,11118,2911,0.624212988,0.362385321,0.261827667
Iowa,19099,Jasper County,12480,7813,20653,4667,0.604270566,0.378298552,0.225972014
Iowa,19101,Jefferson County,4442,4314,8952,128,0.496201966,0.481903485,0.014298481
Iowa,19103,Johnson County,22918,59147,83533,-36229,0.274358637,0.70806747,-0.433708834
Iowa,19105,Jones County,6569,4211,10959,2358,0.599416005,0.384250388,0.215165617
Iowa,19107,Keokuk County,3785,1409,5273,2376,0.7178077,0.267210317,0.450597383
Iowa,19109,Kossuth County,6244,2681,9030,3563,0.691472868,0.296899225,0.394573643
Iowa,19111,Lee County,9763,6539,16721,3224,0.583876562,0.391065128,0.192811435
Iowa,19113,Linn County,53098,70451,126716,-17353,0.419031535,0.555975567,-0.136944032
Iowa,19115,Louisa County,3500,1726,5326,1774,0.657153586,0.324070597,0.333082989
Iowa,19117,Lucas County,2981,1220,4299,1761,0.693417074,0.283786927,0.409630147
Iowa,19119,Lyon County,5703,1065,6846,4638,0.833041192,0.155565294,0.677475898
Iowa,19121,Madison County,6486,3126,9795,3360,0.662174579,0.31914242,0.343032159
Iowa,19123,Mahaska County,8256,2879,11346,5377,0.727657324,0.253745814,0.473911511
Iowa,19125,Marion County,12657,6170,19217,6487,0.658635583,0.321069886,0.337565697
Iowa,19127,Marshall County,9564,8171,18122,1393,0.527756318,0.450888423,0.076867895
Iowa,19129,Mills County,5572,2500,8247,3072,0.675639627,0.303140536,0.372499091
Iowa,19131,Mitchell County,3665,2048,5797,1617,0.632223564,0.353286183,0.278937381
Iowa,19133,Monona County,3234,1402,4709,1832,0.686770015,0.297727755,0.38904226
Iowa,19135,Monroe County,2975,1078,4085,1897,0.728274174,0.263892289,0.464381885
Iowa,19137,Montgomery County,3653,1583,5313,2070,0.687558818,0.297948428,0.38961039
Iowa,19139,Muscatine County,10823,9372,20671,1451,0.523583765,0.453388806,0.070194959
Iowa,19141,O'Brien County,5857,1567,7535,4290,0.777305906,0.20796284,0.569343066
Iowa,19143,Osceola County,2688,600,3325,2088,0.808421053,0.180451128,0.627969925
Iowa,19145,Page County,5314,2081,7509,3233,0.707684112,0.277134106,0.430550007
Iowa,19147,Palo Alto County,3369,1518,4948,1851,0.680881164,0.306790622,0.374090542
Iowa,19149,Plymouth County,10472,3483,14157,6989,0.73970474,0.246026701,0.493678039
Iowa,19151,Pocahontas County,2825,932,3821,1893,0.739335253,0.243915205,0.495420047
Iowa,19153,Polk County,106752,146173,258613,-39421,0.412786674,0.565219073,-0.152432399
Iowa,19155,Pottawattamie County,26241,18570,45733,7671,0.573786981,0.406052522,0.167734459
Iowa,19157,Poweshiek County,5645,4301,10120,1344,0.557806324,0.425,0.132806324
Iowa,19159,Ringgold County,1964,708,2709,1256,0.724990772,0.261351052,0.463639719
Iowa,19161,Sac County,4052,1383,5512,2669,0.735123367,0.250907112,0.484216255
Iowa,19163,Scott County,43661,46890,92639,-3229,0.471302583,0.506158313,-0.03485573
Iowa,19165,Shelby County,4697,1959,6781,2738,0.692670698,0.288895443,0.403775254
Iowa,19167,Sioux County,15669,3017,18943,12652,0.827165708,0.159267276,0.667898432
Iowa,19169,Story County,20200,28975,50668,-8775,0.398673719,0.571859951,-0.173186232
Iowa,19171,Tama County,5299,3573,9017,1726,0.587667739,0.396251525,0.191416214
Iowa,19173,Taylor County,2459,745,3237,1714,0.759654001,0.230151375,0.529502626
Iowa,19175,Union County,4000,2049,6163,1951,0.649034561,0.332467954,0.316566607
Iowa,19177,Van Buren County,2867,874,3795,1993,0.755467721,0.23030303,0.52516469
Iowa,19179,Wapello County,9504,5818,15607,3686,0.608957519,0.372781444,0.236176075
Iowa,19181,Warren County,17738,12537,30955,5201,0.573025359,0.405007269,0.168018091
Iowa,19183,Washington County,6966,4558,11757,2408,0.592498086,0.387683933,0.204814153
Iowa,19185,Wayne County,2338,727,3103,1611,0.753464389,0.234289397,0.519174992
Iowa,19187,Webster County,10927,6604,17802,4323,0.613807437,0.370969554,0.242837883
Iowa,19189,Winnebago County,3692,2123,5931,1569,0.622491991,0.357949756,0.264542236
Iowa,19191,Winneshiek County,6234,5616,12034,618,0.518032242,0.466677746,0.051354496
Iowa,19193,Woodbury County,25700,18683,45114,7017,0.569667952,0.414128652,0.1555393
Iowa,19195,Worth County,2732,1593,4405,1139,0.620204313,0.361634506,0.258569807
Iowa,19197,Wright County,4135,1995,6240,2140,0.662660256,0.319711538,0.342948718
Kansas,20001,Allen County,5486,1836,7484,3650,0.733030465,0.245323356,0.487707108
Kansas,20003,Anderson County,2874,765,3720,2109,0.772580645,0.205645161,0.566935484
Kansas,20005,Atchison County,4826,2314,7312,2512,0.660010941,0.316466083,0.343544858
Kansas,20007,Barber County,1992,284,2313,1708,0.861219196,0.122784263,0.738434933
Kansas,20009,Barton County,8480,2302,10980,6178,0.772313297,0.209653916,0.562659381
Kansas,20011,Bourbon County,4906,1504,6545,3402,0.749579832,0.229793736,0.519786096
Kansas,20013,Brown County,3206,1088,4396,2118,0.729299363,0.247497725,0.481801638
Kansas,20015,Butler County,22250,9003,31946,13247,0.696487823,0.28181932,0.414668503
Kansas,20017,Chase County,1114,341,1478,773,0.753721245,0.230717185,0.52300406
Kansas,20019,Chautauqua County,1397,212,1634,1185,0.85495716,0.129742962,0.725214198
Kansas,20021,Cherokee County,6622,2163,8945,4459,0.740301845,0.241811068,0.498490777
Kansas,20023,Cheyenne County,1158,220,1400,938,0.827142857,0.157142857,0.67
Kansas,20025,Clark County,885,143,1048,742,0.844465649,0.136450382,0.708015267
Kansas,20027,Clay County,3120,879,4121,2241,0.757097792,0.213297743,0.543800049
Kansas,20029,Cloud County,3182,893,4179,2289,0.761426179,0.213687485,0.547738693
Kansas,20031,Coffey County,3403,926,4442,2477,0.766096353,0.208464656,0.557631697
Kansas,20033,Comanche County,743,124,900,619,0.825555556,0.137777778,0.687777778
Kansas,20035,Cowley County,9442,4171,13958,5271,0.676457945,0.298825047,0.377632899
Kansas,20037,Crawford County,9752,5971,16193,3781,0.602235534,0.368739579,0.233495955
Kansas,20039,Decatur County,1232,208,1458,1024,0.844993141,0.14266118,0.702331962
Kansas,20041,Dickinson County,7045,2040,9246,5005,0.761951114,0.220635951,0.541315163
Kansas,20043,Doniphan County,2949,678,3682,2271,0.800923411,0.184139055,0.616784356
Kansas,20045,Douglas County,16737,39436,57946,-22699,0.288837884,0.680564664,-0.39172678
Kansas,20047,Edwards County,1127,267,1413,860,0.797593772,0.18895966,0.608634112
Kansas,20049,Elk County,1130,191,1347,939,0.838901262,0.141796585,0.697104677
Kansas,20051,Ellis County,9569,3633,13552,5936,0.706095041,0.268078512,0.438016529
Kansas,20053,Ellsworth County,2106,646,2813,1460,0.748666904,0.229648063,0.519018841
Kansas,20055,Finney County,7079,4155,11506,2924,0.61524422,0.36111594,0.254128281
Kansas,20057,Ford County,5763,2926,8850,2837,0.651186441,0.330621469,0.320564972
Kansas,20059,Franklin County,8326,3623,12247,4703,0.679839961,0.29582755,0.384012411
Kansas,20061,Geary County,5193,3825,9311,1368,0.557727419,0.410804425,0.146922994
Kansas,20063,Gove County,1256,163,1433,1093,0.876482903,0.113747383,0.76273552
Kansas,20065,Graham County,1052,222,1302,830,0.807987711,0.170506912,0.637480799
Kansas,20067,Grant County,1910,497,2452,1413,0.778955954,0.20269168,0.576264274
Kansas,20069,Gray County,1871,337,2240,1534,0.835267857,0.150446429,0.684821429
Kansas,20071,Greeley County,537,76,628,461,0.855095541,0.121019108,0.734076433
Kansas,20073,Greenwood County,2404,562,3036,1842,0.791831357,0.185111989,0.606719368
Kansas,20075,Hamilton County,684,134,837,550,0.817204301,0.160095579,0.657108722
Kansas,20077,Harper County,2128,453,2628,1675,0.809741248,0.172374429,0.637366819
Kansas,20079,Harvey County,10015,6652,17120,3363,0.584988318,0.388551402,0.196436916
Kansas,20081,Haskell County,1103,261,1383,842,0.797541576,0.188720174,0.608821403
Kansas,20083,Hodgeman County,866,151,1033,715,0.838334947,0.146176186,0.692158761
Kansas,20085,Jackson County,4435,1852,6468,2583,0.685683364,0.286332715,0.399350649
Kansas,20087,Jefferson County,6167,3097,9545,3070,0.646097433,0.32446307,0.321634364
Kansas,20089,Jewell County,1369,211,1608,1158,0.851368159,0.131218905,0.720149254
Kansas,20091,Johnson County,151280,177925,338343,-26645,0.44712023,0.525871675,-0.078751445
Kansas,20093,Kearny County,1134,255,1413,879,0.802547771,0.180467091,0.622080679
Kansas,20095,Kingman County,3098,742,3922,2356,0.789903111,0.189189189,0.600713921
Kansas,20097,Kiowa County,957,153,1139,804,0.840210711,0.134328358,0.705882353
Kansas,20099,Labette County,5639,2607,8414,3032,0.670192536,0.309840742,0.360351795
Kansas,20101,Lane County,757,114,888,643,0.852477477,0.128378378,0.724099099
Kansas,20103,Leavenworth County,21378,13753,36115,7625,0.591942406,0.380811297,0.211131109
Kansas,20105,Lincoln County,1273,266,1570,1007,0.810828025,0.169426752,0.641401274
Kansas,20107,Linn County,3940,863,4911,3077,0.802280595,0.175727958,0.626552637
Kansas,20109,Logan County,1231,185,1437,1046,0.85664579,0.128740431,0.727905358
Kansas,20111,Lyon County,7381,5878,13622,1503,0.541844076,0.431507855,0.110336221
Kansas,20113,McPherson County,9562,3977,13901,5585,0.687864182,0.286094526,0.401769657
Kansas,20115,Marion County,4377,1463,5969,2914,0.733288658,0.245099682,0.488188976
Kansas,20117,Marshall County,3662,1239,5029,2423,0.728176576,0.246371048,0.481805528
Kansas,20119,Meade County,1508,261,1807,1247,0.834532374,0.144438296,0.690094079
Kansas,20121,Miami County,12116,5133,17655,6983,0.686264514,0.290739167,0.395525347
Kansas,20123,Mitchell County,2454,547,3039,1907,0.807502468,0.179993419,0.627509049
Kansas,20125,Montgomery County,9768,3147,13177,6621,0.741291645,0.238825226,0.502466419
Kansas,20127,Morris County,2085,721,2849,1364,0.731835732,0.253071253,0.478764479
Kansas,20129,Morton County,1004,147,1163,857,0.863284609,0.126397248,0.73688736
Kansas,20131,Nemaha County,4612,920,5637,3692,0.818165691,0.16320738,0.654958311
Kansas,20133,Neosho County,4795,1727,6629,3068,0.723336853,0.260521949,0.462814904
Kansas,20135,Ness County,1315,147,1487,1168,0.884330868,0.098856759,0.785474109
Kansas,20137,Norton County,1975,360,2386,1615,0.82774518,0.150880134,0.676865046
Kansas,20139,Osage County,5589,2091,7883,3498,0.708994038,0.265254345,0.443739693
Kansas,20141,Osborne County,1590,275,1904,1315,0.835084034,0.144432773,0.690651261
Kansas,20143,Ottawa County,2581,504,3161,2077,0.816513761,0.159443214,0.657070547
Kansas,20145,Pawnee County,2028,635,2712,1393,0.747787611,0.234144543,0.513643068
Kansas,20147,Phillips County,2855,373,3278,2482,0.870957901,0.113788896,0.757169005
Kansas,20149,Pottawatomie County,9247,3257,12815,5990,0.721576278,0.254155287,0.467420991
Kansas,20151,Pratt County,3087,924,4107,2163,0.751643535,0.224981738,0.526661797
Kansas,20153,Rawlins County,1253,214,1498,1039,0.836448598,0.142857143,0.693591455
Kansas,20155,Reno County,17892,8563,27148,9329,0.659054074,0.315419184,0.34363489
Kansas,20157,Republic County,2172,420,2643,1752,0.821793417,0.158910329,0.662883087
Kansas,20159,Rice County,3187,953,4230,2234,0.753427896,0.225295508,0.528132388
Kansas,20161,Riley County,11174,11940,24024,-766,0.465118215,0.497002997,-0.031884782
Kansas,20163,Rooks County,2294,332,2666,1962,0.860465116,0.124531133,0.735933983
Kansas,20165,Rush County,1425,291,1748,1134,0.815217391,0.166475973,0.648741419
Kansas,20167,Russell County,2765,591,3436,2174,0.804714785,0.172002328,0.632712456
Kansas,20169,Saline County,15313,8022,24001,7291,0.638015083,0.334236073,0.303779009
Kansas,20171,Scott County,1991,290,2325,1701,0.856344086,0.124731183,0.731612903
Kansas,20173,Sedgwick County,117653,90820,214488,26833,0.548529521,0.423426952,0.12510257
Kansas,20175,Seward County,3285,1736,5099,1549,0.644243969,0.340458914,0.303785056
Kansas,20177,Shawnee County,39890,42032,84502,-2142,0.472059833,0.497408345,-0.025348512
Kansas,20179,Sheridan County,1237,144,1397,1093,0.885468862,0.103078024,0.782390838
Kansas,20181,Sherman County,2220,385,2669,1835,0.831772199,0.144248782,0.687523417
Kansas,20183,Smith County,1734,328,2092,1406,0.828871893,0.156787763,0.67208413
Kansas,20185,Stafford County,1631,355,2017,1276,0.808626673,0.176003966,0.632622707
Kansas,20187,Stanton County,607,147,767,460,0.791395046,0.191655802,0.599739244
Kansas,20189,Stevens County,1731,233,1997,1498,0.8668002,0.116675013,0.750125188
Kansas,20191,Sumner County,7998,2551,10816,5447,0.739460059,0.23585429,0.503605769
Kansas,20193,Thomas County,4686,642,5422,4044,0.864256732,0.118406492,0.74585024
Kansas,20195,Trego County,1341,238,1603,1103,0.836556457,0.148471616,0.688084841
Kansas,20197,Wabaunsee County,2813,956,3861,1857,0.728567729,0.247604248,0.480963481
Kansas,20199,Wallace County,762,44,817,718,0.932680539,0.053855569,0.878824969
Kansas,20201,Washington County,2332,467,2855,1865,0.816812609,0.16357268,0.65323993
Kansas,20203,Wichita County,803,147,961,656,0.835587929,0.152965661,0.682622268
Kansas,20205,Wilson County,3111,711,3899,2400,0.797896897,0.18235445,0.615542447
Kansas,20207,Woodson County,1189,283,1496,906,0.794786096,0.189171123,0.605614973
Kansas,20209,Wyandotte County,18512,35566,55379,-17054,0.334278337,0.642229004,-0.307950667
Kentucky,21001,Adair County,7275,1391,8766,5884,0.82991102,0.158681269,0.671229751
Kentucky,21003,Allen County,12706,3031,15951,9675,0.796564479,0.190019435,0.606545044
Kentucky,21005,Anderson County,9651,3339,13261,6312,0.727773169,0.251790966,0.475982203
Kentucky,21007,Ballard County,3356,825,4225,2531,0.794319527,0.195266272,0.599053254
Kentucky,21009,Barren County,14646,5115,20079,9531,0.729418796,0.254743762,0.474675034
Kentucky,21011,Bath County,3986,1573,5627,2413,0.708370357,0.279545051,0.428825307
Kentucky,21013,Bell County,8140,1789,10044,6351,0.81043409,0.178116288,0.632317802
Kentucky,21015,Boone County,44811,20897,66953,23914,0.669290398,0.312114468,0.357175929
Kentucky,21017,Bourbon County,6190,3296,9643,2894,0.641916416,0.341802344,0.300114072
Kentucky,21019,Boyd County,14295,7083,21741,7212,0.657513454,0.325789982,0.331723472
Kentucky,21021,Boyle County,8872,5298,14467,3574,0.613257759,0.36621276,0.247044999
Kentucky,21023,Bracken County,3397,799,4244,2598,0.800424128,0.188265787,0.612158341
Kentucky,21025,Breathitt County,4265,1301,5667,2964,0.752602788,0.229574731,0.523028057
Kentucky,21027,Breckinridge County,7699,2350,10194,5349,0.755248185,0.230527761,0.524720424
Kentucky,21029,Bullitt County,30708,10551,41964,20157,0.731770089,0.251429797,0.480340292
Kentucky,21031,Butler County,4960,1078,6125,3882,0.809795918,0.176,0.633795918
Kentucky,21033,Caldwell County,4905,1432,6436,3473,0.762119329,0.222498446,0.539620883
Kentucky,21035,Calloway County,11351,5794,17453,5557,0.650375294,0.33197731,0.318397983
Kentucky,21037,Campbell County,28482,19373,48833,9109,0.583253128,0.396719432,0.186533696
Kentucky,21039,Carlisle County,2159,463,2638,1696,0.818423048,0.175511751,0.642911296
Kentucky,21041,Carroll County,5490,2146,8444,3344,0.650165798,0.254144955,0.396020843
Kentucky,21043,Carter County,8775,2642,11585,6133,0.757444972,0.228053517,0.529391454
Kentucky,21045,Casey County,6186,960,7240,5226,0.85441989,0.132596685,0.721823204
Kentucky,21047,Christian County,15080,8296,23863,6784,0.631940661,0.347651175,0.284289486
Kentucky,21049,Clark County,17595,8665,26584,8930,0.661864279,0.325947939,0.335916341
Kentucky,21051,Clay County,6003,430,6498,5573,0.923822715,0.066174207,0.857648507
Kentucky,21053,Clinton County,4280,603,4932,3677,0.867802109,0.122262774,0.745539335
Kentucky,21055,Crittenden County,3451,731,4242,2720,0.813531353,0.172324375,0.641206978
Kentucky,21057,Cumberland County,2769,508,3309,2261,0.836808704,0.153520701,0.683288002
Kentucky,21059,Daviess County,31023,17283,49240,13740,0.630036556,0.350995126,0.27904143
Kentucky,21061,Edmonson County,4828,1227,6131,3601,0.787473495,0.200130484,0.587343011
Kentucky,21063,Elliott County,2246,712,2995,1534,0.749916528,0.237729549,0.512186978
Kentucky,21065,Estill County,5100,1355,6540,3745,0.779816514,0.207186544,0.572629969
Kentucky,21067,Fayette County,58845,90566,152664,-31721,0.385454331,0.593237436,-0.207783105
Kentucky,21069,Fleming County,5534,1474,7066,4060,0.783187093,0.208604585,0.574582508
Kentucky,21071,Floyd County,12211,3855,16381,8356,0.745436787,0.235333618,0.510103168
Kentucky,21073,Franklin County,12900,12650,26059,250,0.495030508,0.485436893,0.009593614
Kentucky,21075,Fulton County,1605,791,2421,814,0.662949195,0.326724494,0.336224701
Kentucky,21077,Gallatin County,2955,822,3849,2133,0.767731878,0.213561964,0.554169914
Kentucky,21079,Garrard County,6754,1830,8703,4924,0.776054234,0.21027232,0.565781914
Kentucky,21081,Grant County,8725,2205,11106,6520,0.785611381,0.198541329,0.587070052
Kentucky,21083,Graves County,13206,3559,17018,9647,0.77600188,0.209131508,0.566870373
Kentucky,21085,Grayson County,9453,2400,11994,7053,0.788144072,0.20010005,0.588044022
Kentucky,21087,Green County,4838,920,5812,3918,0.832415692,0.158293187,0.674122505
Kentucky,21089,Greenup County,13064,4873,18176,8191,0.71875,0.268100792,0.450649208
Kentucky,21091,Hancock County,3145,1351,4587,1794,0.685633312,0.294528014,0.391105298
Kentucky,21093,Hardin County,29832,18101,48941,11731,0.609550275,0.369853497,0.239696778
Kentucky,21095,Harlan County,9367,1494,10971,7873,0.853796372,0.136177194,0.717619178
Kentucky,21097,Harrison County,6334,2400,8853,3934,0.715463685,0.271094544,0.44436914
Kentucky,21099,Hart County,6345,1908,8369,4437,0.758155096,0.227984228,0.530170869
Kentucky,21101,Henderson County,12730,7639,20697,5091,0.615064985,0.369087307,0.245977678
Kentucky,21103,Henry County,5843,2142,8107,3701,0.720735167,0.26421611,0.456519058
Kentucky,21105,Hickman County,1714,458,2199,1256,0.779445202,0.208276489,0.571168713
Kentucky,21107,Hopkins County,15757,5439,21512,10318,0.732474898,0.252835627,0.479639271
Kentucky,21109,Jackson County,5450,605,6116,4845,0.891105298,0.098920863,0.792184434
Kentucky,21111,Jefferson County,150619,228288,386093,-77669,0.390110673,0.591277231,-0.201166558
Kentucky,21113,Jessamine County,17096,8567,26251,8529,0.651251381,0.326349472,0.324901908
Kentucky,21115,Johnson County,8446,1607,10193,6839,0.828607868,0.157657216,0.670950652
Kentucky,21117,Kenton County,48123,32265,82183,15858,0.585559057,0.392599443,0.192959615
Kentucky,21119,Knott County,4779,1412,6251,3367,0.764517677,0.225883859,0.538633819
Kentucky,21121,Knox County,11010,2111,13279,8899,0.829128699,0.158972814,0.670155885
Kentucky,21123,Larue County,5685,1504,7301,4181,0.778660457,0.205999178,0.572661279
Kentucky,21125,Laurel County,23234,4474,28097,18760,0.826921024,0.159234082,0.667686942
Kentucky,21127,Lawrence County,5633,1238,6955,4395,0.80992092,0.178001438,0.631919482
Kentucky,21129,Lee County,2159,459,2659,1700,0.811959383,0.172621286,0.639338097
Kentucky,21131,Leslie County,4318,446,4814,3872,0.896967179,0.092646448,0.804320731
Kentucky,21133,Letcher County,7226,1799,9148,5427,0.789899432,0.196655007,0.593244425
Kentucky,21135,Lewis County,4986,823,5883,4163,0.847526772,0.139894612,0.70763216
Kentucky,21137,Lincoln County,8489,2254,10913,6235,0.777879593,0.206542656,0.571336938
Kentucky,21139,Livingston County,4010,939,5003,3071,0.801519089,0.187687388,0.613831701
Kentucky,21141,Logan County,9067,3094,12346,5973,0.734407905,0.250607484,0.483800421
Kentucky,21143,Lyon County,3100,1092,4228,2008,0.73320719,0.258278146,0.474929044
Kentucky,21145,McCracken County,21820,11190,33554,10630,0.650295047,0.333492281,0.316802766
Kentucky,21147,McCreary County,5664,725,6435,4939,0.88018648,0.112665113,0.767521368
Kentucky,21149,McLean County,3633,1074,4782,2559,0.759723965,0.224592221,0.535131744
Kentucky,21151,Madison County,27353,15580,43903,11773,0.623032595,0.354873243,0.268159351
Kentucky,21153,Magoffin County,4174,1213,5446,2961,0.76643408,0.222732281,0.543701799
Kentucky,21155,Marion County,6113,2722,8928,3391,0.684699821,0.304883513,0.379816308
Kentucky,21157,Marshall County,13297,4071,17609,9226,0.75512522,0.231188597,0.523936623
Kentucky,21159,Martin County,3496,403,3930,3093,0.88956743,0.102544529,0.787022901
Kentucky,21161,Mason County,8908,3317,12394,5591,0.718734872,0.267629498,0.451105374
Kentucky,21163,Meade County,10184,3632,14110,6552,0.721757619,0.257406095,0.464351524
Kentucky,21165,Menifee County,2311,750,3102,1561,0.745003224,0.241779497,0.503223727
Kentucky,21167,Mercer County,8506,3033,11735,5473,0.724840222,0.258457605,0.466382616
Kentucky,21169,Metcalfe County,3957,973,5014,2984,0.789190267,0.194056641,0.595133626
Kentucky,21171,Monroe County,4628,657,5330,3971,0.868292683,0.12326454,0.745028143
Kentucky,21173,Montgomery County,8993,3630,12837,5363,0.700553089,0.28277635,0.417776739
Kentucky,21175,Morgan County,4297,1172,5535,3125,0.77633243,0.211743451,0.564588979
Kentucky,21177,Muhlenberg County,10496,3544,14229,6952,0.737648464,0.249068803,0.488579661
Kentucky,21179,Nelson County,15703,7188,23256,8515,0.675223598,0.309081527,0.366142071
Kentucky,21181,Nicholas County,2407,954,3396,1453,0.708775029,0.280918728,0.427856302
Kentucky,21183,Ohio County,8582,2404,11127,6178,0.771277074,0.216051047,0.555226027
Kentucky,21185,Oldham County,22651,14504,37936,8147,0.597084563,0.382328132,0.214756432
Kentucky,21187,Owen County,4292,1098,5456,3194,0.786656891,0.201246334,0.585410557
Kentucky,21189,Owsley County,1670,216,1895,1454,0.881266491,0.113984169,0.767282322
Kentucky,21191,Pendleton County,5515,1322,6925,4193,0.796389892,0.190902527,0.605487365
Kentucky,21193,Perry County,8118,2350,10606,5768,0.765415802,0.221572695,0.543843108
Kentucky,21195,Pike County,20279,4862,25368,15417,0.799392936,0.191658783,0.607734153
Kentucky,21197,Powell County,3966,1281,5344,2685,0.742140719,0.239708084,0.502432635
Kentucky,21199,Pulaski County,25441,5664,31537,19777,0.806703237,0.179598567,0.627104671
Kentucky,21201,Robertson County,884,253,1146,631,0.771378709,0.220767888,0.55061082
Kentucky,21203,Rockcastle County,6577,1134,7784,5443,0.844938335,0.145683453,0.699254882
Kentucky,21205,Rowan County,5994,3880,10058,2114,0.595943528,0.385762577,0.21018095
Kentucky,21207,Russell County,7506,1329,8939,6177,0.839691241,0.148674348,0.691016892
Kentucky,21209,Scott County,17764,10564,28950,7200,0.613609672,0.364905009,0.248704663
Kentucky,21211,Shelby County,15054,8076,23542,6978,0.639452893,0.34304647,0.296406423
Kentucky,21213,Simpson County,5888,2681,8732,3207,0.67430142,0.307031608,0.367269812
Kentucky,21215,Spencer County,8737,2530,11429,6207,0.764458833,0.221366699,0.543092134
Kentucky,21217,Taylor County,9376,2961,12510,6415,0.749480416,0.236690647,0.512789768
Kentucky,21219,Todd County,4060,1202,5351,2858,0.758736685,0.22463091,0.534105775
Kentucky,21221,Trigg County,5487,1791,7375,3696,0.744,0.242847458,0.501152542
Kentucky,21223,Trimble County,3227,1012,4319,2215,0.747163695,0.234313498,0.512850197
Kentucky,21225,Union County,4965,1529,6576,3436,0.755018248,0.232512165,0.522506083
Kentucky,21227,Warren County,31790,22477,55351,9313,0.5743347,0.406081191,0.168253509
Kentucky,21229,Washington County,4482,1644,6223,2838,0.7202314,0.264181263,0.456050137
Kentucky,21231,Wayne County,7430,1700,9240,5730,0.804112554,0.183982684,0.62012987
Kentucky,21233,Webster County,4506,1412,5991,3094,0.752128192,0.235686864,0.516441329
Kentucky,21235,Whitley County,12567,2552,15347,10015,0.818857106,0.166286571,0.652570535
Kentucky,21237,Wolfe County,2097,837,2981,1260,0.703455216,0.280778262,0.422676954
Kentucky,21239,Woodford County,8362,6530,15211,1832,0.549733745,0.429294589,0.120439156
Louisiana,22001,Acadia Parish,22596,5443,28425,17153,0.794934037,0.191486368,0.603447669
Louisiana,22003,Allen Parish,7574,2108,9810,5466,0.772069317,0.214882773,0.557186544
Louisiana,22005,Ascension Parish,40687,20399,62325,20288,0.652819896,0.327300441,0.325519454
Louisiana,22007,Assumption Parish,7271,3833,11235,3438,0.64717401,0.341165999,0.306008011
Louisiana,22009,Avoyelles Parish,12028,4979,17292,7049,0.695581772,0.287936618,0.407645154
Louisiana,22011,Beauregard Parish,13575,2542,16357,11033,0.829919912,0.155407471,0.674512441
Louisiana,22013,Bienville Parish,3891,3066,7049,825,0.551993191,0.434955313,0.117037878
Louisiana,22015,Bossier Parish,38065,15658,54642,22407,0.696625307,0.286556129,0.410069178
Louisiana,22017,Caddo Parish,47927,54993,104699,-7066,0.457759864,0.52524857,-0.067488706
Louisiana,22019,Calcasieu Parish,55066,25982,82663,29084,0.666150515,0.314312328,0.351838186
Louisiana,22021,Caldwell Parish,3976,745,4762,3231,0.834943301,0.156446871,0.67849643
Louisiana,22023,Cameron Parish,3671,324,4039,3347,0.908888339,0.080217876,0.828670463
Louisiana,22025,Catahoula Parish,3541,1269,4858,2272,0.728900782,0.261218608,0.467682174
Louisiana,22027,Claiborne Parish,3770,2731,6580,1039,0.572948328,0.415045593,0.157902736
Louisiana,22029,Concordia Parish,5550,3177,8828,2373,0.628681468,0.359877662,0.268803806
Louisiana,22031,De Soto Parish,9112,5457,14736,3655,0.61834962,0.37031759,0.24803203
Louisiana,22033,East Baton Rouge Parish,88396,115533,208111,-27137,0.424754098,0.555150857,-0.130396759
Louisiana,22035,East Carroll Parish,1080,1900,3036,-820,0.355731225,0.625823452,-0.270092227
Louisiana,22037,East Feliciana Parish,6064,4280,10509,1784,0.577029213,0.407269959,0.169759254
Louisiana,22039,Evangeline Parish,11053,4158,15412,6895,0.71716844,0.269789774,0.447378666
Louisiana,22041,Franklin Parish,6970,2658,9720,4312,0.717078189,0.27345679,0.443621399
Louisiana,22043,Grant Parish,8117,1157,9392,6960,0.864246167,0.123189949,0.741056218
Louisiana,22045,Iberia Parish,21251,11027,32713,10224,0.649619417,0.337083117,0.312536301
Louisiana,22047,Iberville Parish,7893,8514,16719,-621,0.472097613,0.509240983,-0.03714337
Louisiana,22049,Jackson Parish,5394,2143,7632,3251,0.706761006,0.280791405,0.425969602
Louisiana,22051,Jefferson Parish,105890,84438,193631,21452,0.546864913,0.436076868,0.110788045
Louisiana,22053,Jefferson Davis Parish,11423,3208,14841,8215,0.769692069,0.216157941,0.553534128
Louisiana,22055,Lafayette Parish,72519,39685,114521,32834,0.633237572,0.346530331,0.286707241
Louisiana,22057,Lafourche Parish,36024,8672,45388,27352,0.793689962,0.191063717,0.602626245
Louisiana,22059,LaSalle Parish,6348,574,6982,5774,0.909195073,0.082211401,0.826983672
Louisiana,22061,Lincoln Parish,11311,7559,19275,3752,0.586822309,0.392166018,0.194656291
Louisiana,22063,Livingston Parish,54877,9249,65230,45628,0.841284685,0.141790587,0.699494098
Louisiana,22065,Madison Parish,1930,2654,4670,-724,0.413276231,0.568308351,-0.15503212
Louisiana,22067,Morehouse Parish,6510,4946,11574,1564,0.5624676,0.427337135,0.135130465
Louisiana,22069,Natchitoches Parish,9358,6896,16554,2462,0.565301438,0.416576054,0.148725384
Louisiana,22071,Orleans Parish,26645,147729,177670,-121084,0.149969044,0.83147971,-0.681510666
Louisiana,22073,Ouachita Parish,42255,25913,69166,16342,0.610921551,0.374649394,0.236272157
Louisiana,22075,Plaquemines Parish,7411,3413,11012,3998,0.672993098,0.309934617,0.363058482
Louisiana,22077,Pointe Coupee Parish,7503,4683,12371,2820,0.60649907,0.378546601,0.227952469
Louisiana,22079,Rapides Parish,38346,19472,58861,18874,0.651467016,0.330813272,0.320653744
Louisiana,22081,Red River Parish,2413,1644,4132,769,0.583978703,0.397870281,0.186108422
Louisiana,22083,Richland Parish,6607,3225,9940,3382,0.664688129,0.32444668,0.340241449
Louisiana,22085,Sabine Parish,8776,1731,10596,7045,0.828237071,0.163363533,0.664873537
Louisiana,22087,St. Bernard Parish,11178,6151,17649,5027,0.633350331,0.34851833,0.284832002
Louisiana,22089,St. Charles Parish,18233,9800,28517,8433,0.639373006,0.343654662,0.295718343
Louisiana,22091,St. Helena Parish,2714,3346,6158,-632,0.440727509,0.543358233,-0.102630724
Louisiana,22093,St. James Parish,5954,6509,12589,-555,0.472952578,0.517038685,-0.044086107
Louisiana,22095,St. John the Baptist Parish,7538,13581,21431,-6043,0.35173347,0.63370818,-0.28197471
Louisiana,22097,St. Landry Parish,23171,17372,41154,5799,0.56303154,0.422121786,0.140909754
Louisiana,22099,St. Martin Parish,18203,8439,27038,9764,0.673237666,0.312116281,0.361121385
Louisiana,22101,St. Mary Parish,14811,8055,23186,6756,0.63879065,0.347407919,0.291382731
Louisiana,22103,St. Tammany Parish,99666,37746,140110,61920,0.711341089,0.269402612,0.441938477
Louisiana,22105,Tangipahoa Parish,37799,18883,57650,18916,0.655663487,0.327545533,0.328117953
Louisiana,22107,Tensas Parish,1197,1329,2554,-132,0.468676586,0.520360219,-0.051683634
Louisiana,22109,Terrebonne Parish,34339,11198,46240,23141,0.742625433,0.24217128,0.500454152
Louisiana,22111,Union Parish,8407,2654,11201,5753,0.750557986,0.23694313,0.513614856
Louisiana,22113,Vermilion Parish,21930,5009,27324,16921,0.802591129,0.183318694,0.619272434
Louisiana,22115,Vernon Parish,14107,2898,17268,11209,0.816944637,0.167824878,0.649119759
Louisiana,22117,Washington Parish,13307,5970,19513,7337,0.681955619,0.30594988,0.37600574
Louisiana,22119,Webster Parish,11829,6172,18215,5657,0.649409827,0.338841614,0.310568213
Louisiana,22121,West Baton Rouge Parish,7684,6200,14097,1484,0.545080514,0.439809889,0.105270625
Louisiana,22123,West Carroll Parish,4317,710,5052,3607,0.854513064,0.140538401,0.713974663
Louisiana,22125,West Feliciana Parish,3863,2298,6268,1565,0.616305041,0.366624123,0.249680919
Louisiana,22127,Winn Parish,4617,1543,6223,3074,0.741925117,0.247951149,0.493973968
Maine,23001,Androscoggin County,29259,27568,58770,1691,0.497856049,0.469082865,0.028773184
Maine,23003,Aroostook County,19622,13318,33686,6304,0.58249718,0.395357122,0.187140058
Maine,23005,Cumberland County,59491,128563,193945,-69072,0.306741602,0.662883807,-0.356142205
Maine,23007,Franklin County,7169,6889,14635,280,0.489853092,0.470720875,0.019132217
Maine,23009,Hancock County,13662,18412,33035,-4750,0.413561374,0.557348267,-0.143786893
Maine,23011,Kennebec County,33801,33957,70029,-156,0.482671465,0.484899113,-0.002227649
Maine,23013,Knox County,9870,14798,25303,-4928,0.390072323,0.584831838,-0.194759515
Maine,23015,Lincoln County,9723,11807,22142,-2084,0.439120224,0.533239996,-0.094119772
Maine,23017,Oxford County,16860,14027,31884,2833,0.528791871,0.439938527,0.088853343
Maine,23019,Penobscot County,39987,35267,77955,4720,0.512949779,0.452402027,0.060547752
Maine,23021,Piscataquis County,5703,3273,9224,2430,0.618278404,0.354835212,0.263443192
Maine,23023,Sagadahoc County,9755,13531,24042,-3776,0.405748274,0.562806755,-0.157058481
Maine,23025,Somerset County,13915,8971,23529,4944,0.591397849,0.381274172,0.210123677
Maine,23027,Waldo County,10939,12156,23905,-1217,0.457603012,0.508512863,-0.050909851
Maine,23029,Washington County,6657,4409,11346,2248,0.5867266,0.3885951,0.1981315
Maine,23031,York County,54099,72363,130346,-18264,0.415041505,0.55516088,-0.140119375
Maryland,24001,Allegany County,19939,8050,28419,11889,0.701608079,0.283261198,0.418346881
Maryland,24003,Anne Arundel County,110684,133998,249413,-23314,0.443777991,0.537253471,-0.09347548
Maryland,24005,Baltimore County,119305,177865,302247,-58560,0.394726829,0.588475651,-0.193748821
Maryland,24009,Calvert County,24786,21814,47463,2972,0.522217306,0.45960011,0.062617197
Maryland,24011,Caroline County,9237,3572,13110,5665,0.704576659,0.272463768,0.432112891
Maryland,24013,Carroll County,54176,29135,86188,25041,0.628579385,0.338040098,0.290539286
Maryland,24015,Cecil County,28257,15459,44672,12798,0.632543875,0.346055695,0.286488181
Maryland,24017,Charles County,21419,42306,64714,-20887,0.330979386,0.653737986,-0.322758599
Maryland,24019,Dorchester County,7804,5295,13371,2509,0.583651185,0.396006282,0.187644903
Maryland,24021,Frederick County,57915,65506,126818,-7591,0.456678074,0.516535508,-0.059857433
Maryland,24023,Garrett County,11654,3098,15045,8556,0.774609505,0.205915587,0.568693918
Maryland,24025,Harford County,69468,43381,115796,26087,0.599917096,0.374632975,0.22528412
Maryland,24027,Howard County,46442,122060,172813,-75618,0.268741356,0.706312604,-0.437571248
Maryland,24029,Kent County,4707,4830,9729,-123,0.483811286,0.496453901,-0.012642615
Maryland,24031,Montgomery County,72888,265188,345549,-192300,0.210933905,0.76743964,-0.556505734
Maryland,24033,Prince George's County,32577,326546,365857,-293969,0.089042987,0.892550915,-0.803507928
Maryland,24035,Queen Anne's County,18179,10209,28990,7970,0.627078303,0.352155916,0.274922387
Maryland,24037,St. Mary's County,30245,22511,54097,7734,0.559088304,0.41612289,0.142965414
Maryland,24039,Somerset County,5405,3542,9073,1863,0.595723575,0.390389066,0.205334509
Maryland,24041,Talbot County,10524,10408,21305,116,0.493968552,0.488523821,0.005444731
Maryland,24043,Washington County,38232,23448,62972,14784,0.607126977,0.372355968,0.234771009
Maryland,24045,Wicomico County,21878,20150,42944,1728,0.509454173,0.469215723,0.04023845
Maryland,24047,Worcester County,15386,7898,23587,7488,0.652308475,0.334845466,0.317463009
Maryland,24510,Baltimore city,20677,165350,189549,-144673,0.10908525,0.872333803,-0.763248553
Massachusetts,25001,Barnstable County,54132,89732,146896,-35600,0.368505609,0.610853937,-0.242348328
Massachusetts,25003,Berkshire County,14015,41521,56821,-27506,0.246651766,0.730733356,-0.48408159
Massachusetts,25005,Bristol County,118085,150063,274045,-31978,0.430896386,0.547585251,-0.116688865
Massachusetts,25007,Dukes County,2587,9762,12587,-7175,0.205529515,0.775562088,-0.570032573
Massachusetts,25009,Essex County,141135,259792,410009,-118657,0.344224151,0.633625116,-0.289400964
Massachusetts,25011,Franklin County,5958,17148,23784,-11190,0.250504541,0.7209889,-0.470484359
Massachusetts,25013,Hampden County,83816,122302,210828,-38486,0.397556302,0.580103212,-0.18254691
Massachusetts,25015,Hampshire County,21529,61288,84745,-39759,0.254044486,0.723204909,-0.469160422
Massachusetts,25017,Middlesex County,223374,599370,842171,-375996,0.26523592,0.711696318,-0.446460398
Massachusetts,25019,Nantucket County,1912,5234,7297,-3322,0.26202549,0.717281074,-0.455255584
Massachusetts,25021,Norfolk County,116457,254647,379716,-138190,0.306695004,0.670624888,-0.363929884
Massachusetts,25023,Plymouth County,111348,141665,259364,-30317,0.429311701,0.546201477,-0.116889777
Massachusetts,25025,Suffolk County,55699,252661,314110,-196962,0.177323231,0.80437108,-0.627047849
Massachusetts,25027,Worcester County,167250,241068,419569,-73818,0.398623349,0.574561038,-0.175937688
Michigan,26001,Alcona County,4848,2142,7063,2706,0.686393884,0.303270565,0.383123319
Michigan,26003,Alger County,3014,2053,5135,961,0.586952288,0.399805258,0.18714703
Michigan,26005,Allegan County,41381,24447,67182,16934,0.615953678,0.363892114,0.252061564
Michigan,26007,Alpena County,10686,6000,16966,4686,0.629847931,0.353648473,0.276199458
Michigan,26009,Antrim County,9783,7289,17347,2494,0.563959186,0.420187929,0.143771257
Michigan,26011,Arenac County,5928,2773,8830,3155,0.671347678,0.314043035,0.357304643
Michigan,26013,Baraga County,2512,1475,4033,1037,0.622861394,0.365732705,0.257128688
Michigan,26015,Barry County,23473,11804,35914,11669,0.65358913,0.328674055,0.324915075
Michigan,26017,Bay County,30919,21718,53505,9201,0.577871227,0.40590599,0.171965237
Michigan,26019,Benzie County,6600,5480,12259,1120,0.538379966,0.447018517,0.091361449
Michigan,26021,Berrien County,43518,37438,82404,6080,0.528105432,0.454322606,0.073782826
Michigan,26023,Branch County,14066,6161,20540,7905,0.684810127,0.299951315,0.384858812
Michigan,26025,Calhoun County,35900,28417,65568,7483,0.547523182,0.433397389,0.114125793
Michigan,26027,Cass County,16686,9122,26221,7564,0.636360169,0.347889097,0.288471073
Michigan,26029,Charlevoix County,9841,6939,17023,2902,0.578100217,0.407624978,0.170475239
Michigan,26031,Cheboygan County,10171,5435,15849,4736,0.641743959,0.342923844,0.298820115
Michigan,26033,Chippewa County,10682,6651,17675,4031,0.604356436,0.376294201,0.228062235
Michigan,26035,Clare County,10860,5200,16280,5660,0.667076167,0.319410319,0.347665848
Michigan,26037,Clinton County,25095,21963,47902,3132,0.523882093,0.458498601,0.065383491
Michigan,26039,Crawford County,4955,2612,7665,2343,0.646444879,0.340769733,0.305675147
Michigan,26041,Delta County,13206,7605,21154,5601,0.624279096,0.359506476,0.26477262
Michigan,26043,Dickinson County,8469,4569,13268,3900,0.638302683,0.344362376,0.293940308
Michigan,26045,Eaton County,31797,31297,64451,500,0.493351538,0.485593707,0.007757832
Michigan,26047,Emmet County,12135,9662,22176,2473,0.547213203,0.435696248,0.111516955
Michigan,26049,Genesee County,99199,120082,222969,-20883,0.444900412,0.538559172,-0.09365876
Michigan,26051,Gladwin County,9893,4524,14603,5369,0.677463535,0.309799356,0.367664179
Michigan,26053,Gogebic County,4600,3573,8279,1027,0.55562266,0.431573862,0.124048798
Michigan,26055,Grand Traverse County,30502,28682,60226,1820,0.506459004,0.476239498,0.030219507
Michigan,26057,Gratiot County,12102,6693,19148,5409,0.632024232,0.349540422,0.28248381
Michigan,26059,Hillsdale County,17037,5883,23288,11154,0.731578495,0.252619375,0.478959121
Michigan,26061,Houghton County,10380,7755,18540,2625,0.55987055,0.41828479,0.141585761
Michigan,26063,Huron County,11949,5349,17523,6600,0.681903784,0.305255949,0.376647834
Michigan,26065,Ingham County,47640,94221,144797,-46581,0.329012341,0.650710995,-0.321698654
Michigan,26067,Ionia County,20655,10899,32201,9756,0.641439707,0.338467749,0.302971957
Michigan,26069,Iosco County,9760,5371,15386,4389,0.634342909,0.349083582,0.285259327
Michigan,26071,Iron County,4216,2493,6795,1723,0.620456218,0.366887417,0.253568801
Michigan,26073,Isabella County,14815,14072,29409,743,0.503757353,0.478492978,0.025264375
Michigan,26075,Jackson County,47381,32004,81032,15377,0.584719617,0.394955079,0.189764537
Michigan,26077,Kalamazoo County,56823,83674,143640,-26851,0.39559315,0.582525759,-0.186932609
Michigan,26079,Kalkaska County,7436,3003,10627,4433,0.69972711,0.282582102,0.417145008
Michigan,26081,Kent County,165318,186753,359915,-21435,0.459325118,0.518880847,-0.059555728
Michigan,26083,Keweenaw County,862,672,1557,190,0.553628773,0.431599229,0.122029544
Michigan,26085,Lake County,3946,2288,6332,1658,0.623183828,0.361339229,0.261844599
Michigan,26087,Lapeer County,35480,16368,52639,19112,0.674024962,0.310948156,0.363076806
Michigan,26089,Leelanau County,7915,8793,16930,-878,0.46751329,0.519373892,-0.051860602
Michigan,26091,Lenawee County,31539,20916,53448,10623,0.590087562,0.391333633,0.198753929
Michigan,26093,Livingston County,76980,48218,127162,28762,0.605369529,0.379185606,0.226183923
Michigan,26095,Luce County,2109,842,3107,1267,0.678789829,0.271000966,0.407788864
Michigan,26097,Mackinac County,4258,2589,6922,1669,0.615140133,0.374024848,0.241115285
Michigan,26099,Macomb County,264535,225561,496523,38974,0.532774917,0.454281071,0.078493846
Michigan,26101,Manistee County,8321,6107,14654,2214,0.567831309,0.416746281,0.151085028
Michigan,26103,Marquette County,16288,20465,37553,-4177,0.433733656,0.544963119,-0.111229462
Michigan,26105,Mason County,10207,6802,17249,3405,0.591744449,0.394341701,0.197402748
Michigan,26107,Mecosta County,13265,7373,21077,5892,0.629359017,0.349812592,0.279546425
Michigan,26109,Menominee County,8120,4314,12622,3806,0.643321185,0.341784186,0.301536999
Michigan,26111,Midland County,27706,20513,49165,7193,0.563530967,0.417227703,0.146303265
Michigan,26113,Missaukee County,6648,1967,8755,4681,0.759337521,0.224671616,0.534665905
Michigan,26115,Monroe County,52710,32975,87223,19735,0.604313083,0.378053954,0.226259129
Michigan,26117,Montcalm County,21815,9703,32086,12112,0.679891541,0.302406034,0.377485508
Michigan,26119,Montmorency County,4171,1628,5863,2543,0.711410541,0.277673546,0.433736995
Michigan,26121,Muskegon County,44544,45508,91701,-964,0.485752609,0.496265035,-0.010512426
Michigan,26123,Newaygo County,18864,7874,27164,10990,0.694448535,0.289868944,0.404579591
Michigan,26125,Oakland County,328313,438147,778418,-109834,0.421769538,0.562868536,-0.141098998
Michigan,26127,Oceana County,8892,4944,14080,3948,0.631534091,0.351136364,0.280397727
Michigan,26129,Ogemaw County,8253,3475,11907,4778,0.693121693,0.291845133,0.40127656
Michigan,26131,Ontonagon County,2358,1391,3810,967,0.618897638,0.365091864,0.253805774
Michigan,26133,Osceola County,8928,3214,12340,5714,0.72350081,0.260453809,0.463047002
Michigan,26135,Oscoda County,3466,1342,4874,2124,0.71112023,0.275338531,0.435781699
Michigan,26137,Otsego County,9779,4743,14756,5036,0.662713472,0.321428571,0.341284901
Michigan,26139,Ottawa County,100511,64566,168074,35945,0.59801635,0.384152219,0.213864131
Michigan,26141,Presque Isle County,5343,2912,8360,2431,0.639114833,0.348325359,0.290789474
Michigan,26143,Roscommon County,9670,5166,15018,4504,0.643893994,0.343987215,0.299906779
Michigan,26145,Saginaw County,50785,51088,103347,-303,0.49140275,0.49433462,-0.00293187
Michigan,26147,St. Clair County,59185,31363,92063,27822,0.642874988,0.34066889,0.302206098
Michigan,26149,St. Joseph County,18128,9262,27982,8866,0.647845043,0.330998499,0.316846544
Michigan,26151,Sanilac County,16194,5966,22446,10228,0.721464849,0.26579346,0.455671389
Michigan,26153,Schoolcraft County,3090,1589,4745,1501,0.651211802,0.33487882,0.316332982
Michigan,26155,Shiawassee County,23154,15371,39250,7783,0.589910828,0.391617834,0.198292994
Michigan,26157,Tuscola County,20310,8713,29495,11597,0.688591287,0.295406001,0.393185286
Michigan,26159,Van Buren County,21591,16800,39060,4791,0.552764977,0.430107527,0.12265745
Michigan,26161,Washtenaw County,56241,157130,216924,-100889,0.259265918,0.724355074,-0.465089156
Michigan,26163,Wayne County,264149,587074,863382,-322925,0.305946846,0.679970164,-0.374023318
Michigan,26165,Wexford County,12102,5838,18292,6264,0.6616007,0.319155915,0.342444785
Minnesota,27001,Aitkin County,6256,3604,10005,2652,0.625287356,0.36021989,0.265067466
Minnesota,27003,Anoka County,104851,100832,210975,4019,0.496983055,0.477933404,0.01904965
Minnesota,27005,Becker County,12452,6592,19471,5860,0.639515176,0.338554774,0.300960403
Minnesota,27007,Beltrami County,12181,11424,24121,757,0.504995647,0.473612205,0.031383442
Minnesota,27009,Benton County,14375,7280,22211,7095,0.647201837,0.327765522,0.319436315
Minnesota,27011,Big Stone County,1862,1052,2972,810,0.626514132,0.35397039,0.272543742
Minnesota,27013,Blue Earth County,16721,18319,36027,-1598,0.464124129,0.508479751,-0.044355622
Minnesota,27015,Brown County,9548,4745,14623,4803,0.652943992,0.324488819,0.328455173
Minnesota,27017,Carlton County,9787,10094,20361,-307,0.480673837,0.495751682,-0.015077845
Minnesota,27019,Carver County,34006,30761,66104,3245,0.514431804,0.465342491,0.049089314
Minnesota,27021,Cass County,11619,6339,18251,5280,0.636622651,0.347323434,0.289299216
Minnesota,27023,Chippewa County,4250,2226,6611,2024,0.642867947,0.336711541,0.306156406
Minnesota,27025,Chisago County,21909,11798,34513,10111,0.634804277,0.341842204,0.292962072
Minnesota,27027,Clay County,15031,16345,32215,-1314,0.466583889,0.507372342,-0.040788453
Minnesota,27029,Clearwater County,3371,1258,4705,2113,0.716471838,0.267375133,0.449096706
Minnesota,27031,Cook County,1202,2494,3786,-1292,0.317485473,0.658742736,-0.341257264
Minnesota,27033,Cottonwood County,4164,1834,6095,2330,0.683182937,0.300902379,0.382280558
Minnesota,27035,Crow Wing County,25668,13723,40160,11945,0.639143426,0.341708167,0.297435259
Minnesota,27037,Dakota County,109033,145206,260665,-36173,0.418287841,0.557059828,-0.138771987
Minnesota,27039,Dodge County,8574,4074,12953,4500,0.661931599,0.314521732,0.347409866
Minnesota,27041,Douglas County,15790,7864,24106,7926,0.655023646,0.326225836,0.32879781
Minnesota,27043,Faribault County,5186,2529,7885,2657,0.657704502,0.320735574,0.336968928
Minnesota,27045,Fillmore County,7298,4551,12136,2747,0.601351351,0.375,0.226351351
Minnesota,27047,Freeborn County,9578,6889,16813,2689,0.569678225,0.409742461,0.159935764
Minnesota,27049,Goodhue County,16052,11802,28563,4250,0.561985786,0.413191892,0.148793894
Minnesota,27051,Grant County,2267,1299,3647,968,0.6216068,0.356183164,0.265423636
Minnesota,27053,Hennepin County,205877,532373,753716,-326496,0.273149303,0.706331032,-0.433181729
Minnesota,27055,Houston County,6332,4851,11435,1481,0.553738522,0.424223874,0.129514648
Minnesota,27057,Hubbard County,8202,4462,12927,3740,0.63448596,0.345169026,0.289316934
Minnesota,27059,Isanti County,16491,7138,24162,9353,0.682518003,0.295422564,0.387095439
Minnesota,27061,Itasca County,15232,10784,26502,4448,0.574749076,0.406912686,0.16783639
Minnesota,27063,Jackson County,3945,1744,5809,2201,0.679118609,0.300223791,0.378894818
Minnesota,27065,Kanabec County,6276,2773,9234,3503,0.679662118,0.300303227,0.379358891
Minnesota,27067,Kandiyohi County,14433,8434,23301,5999,0.619415476,0.361958714,0.257456762
Minnesota,27069,Kittson County,1545,1006,2638,539,0.585670963,0.381349507,0.204321456
Minnesota,27071,Koochiching County,4131,2657,6920,1474,0.596965318,0.383959538,0.21300578
Minnesota,27073,Lac qui Parle County,2527,1445,4039,1082,0.625649913,0.357761822,0.267888091
Minnesota,27075,Lake County,3392,3646,7200,-254,0.471111111,0.506388889,-0.035277778
Minnesota,27077,Lake of the Woods County,1704,671,2405,1033,0.708523909,0.279002079,0.42952183
Minnesota,27079,Le Sueur County,10774,5669,16772,5105,0.642380157,0.338003816,0.304376342
Minnesota,27081,Lincoln County,2120,937,3114,1183,0.680796403,0.300899165,0.379897238
Minnesota,27083,Lyon County,7975,4624,12877,3351,0.61932127,0.35908985,0.26023142
Minnesota,27085,McLeod County,13982,6410,20909,7572,0.668707255,0.30656655,0.362140705
Minnesota,27087,Mahnomen County,1142,1110,2302,32,0.496090356,0.482189401,0.013900956
Minnesota,27089,Marshall County,3716,1293,5093,2423,0.729628902,0.253877872,0.475751031
Minnesota,27091,Martin County,7476,3304,11038,4172,0.677296612,0.299329589,0.377967023
Minnesota,27093,Meeker County,9352,3865,13493,5487,0.693100126,0.286444823,0.406655303
Minnesota,27095,Mille Lacs County,9948,4401,14658,5547,0.678673762,0.3002456,0.378428162
Minnesota,27097,Morrison County,14815,4365,19517,10450,0.759081826,0.223651176,0.53543065
Minnesota,27099,Mower County,10067,8997,19441,1070,0.517823157,0.462784836,0.055038321
Minnesota,27101,Murray County,3362,1449,4882,1913,0.688652192,0.296804588,0.391847603
Minnesota,27103,Nicollet County,9016,9619,19118,-603,0.471597447,0.503138404,-0.031540956
Minnesota,27105,Nobles County,5598,2928,8708,2670,0.642857143,0.336242536,0.306614607
Minnesota,27107,Norman County,1954,1404,3434,550,0.569015725,0.40885265,0.160163075
Minnesota,27109,Olmsted County,39687,49486,91074,-9799,0.43576652,0.543360344,-0.107593825
Minnesota,27111,Otter Tail County,23794,11940,36372,11854,0.654184538,0.328274497,0.325910041
Minnesota,27113,Pennington County,4532,2567,7262,1965,0.624070504,0.353483889,0.270586615
Minnesota,27115,Pine County,10256,5416,15998,4840,0.641080135,0.338542318,0.302537817
Minnesota,27117,Pipestone County,3553,1306,4932,2247,0.720397405,0.264801298,0.455596107
Minnesota,27119,Polk County,9857,5435,15581,4422,0.632629485,0.348822284,0.283807201
Minnesota,27121,Pope County,4413,2478,7019,1935,0.62872204,0.353041744,0.275680296
Minnesota,27123,Ramsey County,77323,211357,294507,-134034,0.262550635,0.717663757,-0.455113121
Minnesota,27125,Red Lake County,1450,689,2190,761,0.662100457,0.314611872,0.347488584
Minnesota,27127,Redwood County,5775,2358,8290,3417,0.696622437,0.284439083,0.412183353
Minnesota,27129,Renville County,5465,2497,8115,2968,0.673444239,0.307701787,0.365742452
Minnesota,27131,Rice County,17455,17386,35582,69,0.490557023,0.48861784,0.001939183
Minnesota,27133,Rock County,3578,1554,5232,2024,0.683868502,0.297018349,0.386850153
Minnesota,27135,Roseau County,6053,2182,8390,3871,0.721454112,0.260071514,0.461382598
Minnesota,27137,St. Louis County,49214,67836,119859,-18622,0.410599121,0.565965009,-0.155365888
Minnesota,27139,Scott County,45840,40007,87664,5833,0.52290564,0.456367494,0.066538146
Minnesota,27141,Sherburne County,36205,18056,55456,18149,0.652859925,0.32559146,0.327268465
Minnesota,27143,Sibley County,5864,2417,8451,3447,0.693882381,0.286001657,0.407880724
Minnesota,27145,Stearns County,50960,31883,84647,19077,0.602029605,0.376658358,0.225371248
Minnesota,27147,Steele County,12656,7916,21125,4740,0.599100592,0.374721893,0.224378698
Minnesota,27149,Stevens County,3045,1921,5063,1124,0.601422082,0.379419317,0.222002765
Minnesota,27151,Swift County,3316,1784,5185,1532,0.639537126,0.344069431,0.295467695
Minnesota,27153,Todd County,9755,3286,13238,6469,0.736893791,0.248224807,0.488668983
Minnesota,27155,Traverse County,1173,662,1864,511,0.629291845,0.355150215,0.274141631
Minnesota,27157,Wabasha County,8149,4691,13088,3458,0.622631418,0.358419927,0.264211491
Minnesota,27159,Wadena County,5517,2021,7656,3496,0.720611285,0.263975967,0.456635319
Minnesota,27161,Waseca County,6623,3494,10386,3129,0.637685346,0.336414404,0.301270942
Minnesota,27163,Washington County,73749,89136,166222,-15387,0.443677732,0.536246706,-0.092568974
Minnesota,27165,Watonwan County,3103,1987,5191,1116,0.597765363,0.382777885,0.214987478
Minnesota,27167,Wilkin County,2333,1027,3435,1306,0.679184862,0.298981077,0.380203785
Minnesota,27169,Winona County,13227,13330,27105,-103,0.487991146,0.491791182,-0.003800037
Minnesota,27171,Wright County,53565,30854,86535,22711,0.618998093,0.356549373,0.26244872
Minnesota,27173,Yellow Medicine County,3734,1685,5525,2049,0.675837104,0.304977376,0.370859729
Mississippi,28001,Adams County,5222,6914,12268,-1692,0.425660254,0.563580046,-0.137919791
Mississippi,28003,Alcorn County,12689,2741,15639,9948,0.811369013,0.175266961,0.636102053
Mississippi,28005,Amite County,3781,2114,5974,1667,0.632909274,0.353866756,0.279042518
Mississippi,28007,Attala County,5178,3542,8832,1636,0.586277174,0.401041667,0.185235507
Mississippi,28009,Benton County,2553,1661,4257,892,0.599718111,0.390180879,0.209537233
Mississippi,28011,Bolivar County,4260,7203,11631,-2943,0.366262574,0.619293268,-0.253030694
Mississippi,28013,Calhoun County,4592,1878,6536,2714,0.702570379,0.287331701,0.415238678
Mississippi,28015,Carroll County,3257,1203,4509,2054,0.722333112,0.266799734,0.455533378
Mississippi,28017,Chickasaw County,4173,3808,8143,365,0.512464694,0.467640919,0.044823775
Mississippi,28019,Choctaw County,2971,1170,4175,1801,0.711616766,0.280239521,0.431377246
Mississippi,28021,Claiborne County,479,2337,2886,-1858,0.165973666,0.80977131,-0.643797644
Mississippi,28023,Clarke County,5372,2815,8277,2557,0.649027425,0.34009907,0.308928356
Mississippi,28025,Clay County,4147,5728,10054,-1581,0.412472648,0.569723493,-0.157250845
Mississippi,28027,Coahoma County,1846,5189,7136,-3343,0.258688341,0.727158072,-0.468469731
Mississippi,28029,Copiah County,5407,5227,10800,180,0.500648148,0.483981481,0.016666667
Mississippi,28031,Covington County,5811,3382,9294,2429,0.625242092,0.363890682,0.26135141
Mississippi,28033,DeSoto County,45788,27733,75013,18055,0.610400864,0.36970925,0.240691613
Mississippi,28035,Forrest County,15326,10603,26540,4723,0.577467973,0.399510173,0.1779578
Mississippi,28037,Franklin County,2894,1476,4431,1418,0.653125705,0.333107651,0.320018055
Mississippi,28039,George County,9602,1208,10940,8394,0.877696527,0.110420475,0.767276051
Mississippi,28041,Greene County,4740,952,5748,3788,0.824634656,0.165622825,0.65901183
Mississippi,28043,Grenada County,4889,2866,7838,2023,0.62375606,0.365654504,0.258101557
Mississippi,28045,Hancock County,13999,3095,17403,10904,0.80440154,0.177842901,0.626558639
Mississippi,28047,Harrison County,41281,18499,60941,22782,0.677392888,0.303555898,0.37383699
Mississippi,28049,Hinds County,21242,59192,81811,-37950,0.259647236,0.723521287,-0.463874051
Mississippi,28051,Holmes County,1196,5182,6542,-3986,0.18281871,0.792112504,-0.609293794
Mississippi,28053,Humphreys County,1115,2994,4164,-1879,0.267771374,0.719020173,-0.451248799
Mississippi,28055,Issaquena County,308,355,676,-47,0.455621302,0.525147929,-0.069526627
Mississippi,28057,Itawamba County,9374,1230,10743,8144,0.872568184,0.114493158,0.758075026
Mississippi,28059,Jackson County,32563,12061,45486,20502,0.715890604,0.26515851,0.450732093
Mississippi,28061,Jasper County,4256,4287,8642,-31,0.492478593,0.496065726,-0.003587133
Mississippi,28063,Jefferson County,529,3325,3907,-2796,0.135398004,0.851036601,-0.715638597
Mississippi,28065,Jefferson Davis County,1927,2645,4650,-718,0.414408602,0.568817204,-0.154408602
Mississippi,28067,Jones County,19130,7017,26492,12113,0.722104786,0.264872414,0.457232372
Mississippi,28069,Kemper County,1609,2275,3935,-666,0.408894536,0.578144854,-0.169250318
Mississippi,28071,Lafayette County,9878,6904,17163,2974,0.575540407,0.402260677,0.17327973
Mississippi,28073,Lamar County,20406,7205,28082,13201,0.726657645,0.256570045,0.470087601
Mississippi,28075,Lauderdale County,17812,12668,30811,5144,0.578105222,0.411151861,0.166953361
Mississippi,28077,Lawrence County,4254,2240,6564,2014,0.648080439,0.341255332,0.306825107
Mississippi,28079,Leake County,4973,3358,8407,1615,0.591530867,0.399429047,0.19210182
Mississippi,28081,Lee County,21297,9910,31762,11387,0.670518229,0.31200806,0.358510169
Mississippi,28083,Leflore County,2623,5444,8178,-2821,0.320738567,0.665688432,-0.344949865
Mississippi,28085,Lincoln County,10107,3978,14247,6129,0.709412508,0.279216677,0.430195831
Mississippi,28087,Lowndes County,13699,12913,26993,786,0.507501945,0.478383285,0.02911866
Mississippi,28089,Madison County,26188,18931,45832,7257,0.571391168,0.413052016,0.158339152
Mississippi,28091,Marion County,7783,3421,11338,4362,0.686452637,0.3017287,0.384723937
Mississippi,28093,Marshall County,6591,6283,13064,308,0.504516228,0.480939988,0.02357624
Mississippi,28095,Monroe County,9677,4565,14461,5112,0.669179172,0.315676648,0.353502524
Mississippi,28097,Montgomery County,2866,2084,4972,782,0.576427997,0.419147224,0.157280772
Mississippi,28099,Neshoba County,8311,3247,11698,5064,0.710463327,0.277568815,0.432894512
Mississippi,28101,Newton County,6037,2542,8678,3495,0.695667204,0.292924637,0.402742567
Mississippi,28103,Noxubee County,1057,2867,3981,-1810,0.265511178,0.720170811,-0.454659633
Mississippi,28105,Oktibbeha County,8972,10257,19737,-1285,0.454577697,0.519683843,-0.065106146
Mississippi,28107,Panola County,7976,7276,15421,700,0.517216782,0.471824136,0.045392646
Mississippi,28109,Pearl River County,19283,4068,23656,15215,0.815142036,0.171964829,0.643177207
Mississippi,28111,Perry County,4426,1340,5825,3086,0.759828326,0.230042918,0.529785408
Mississippi,28113,Pike County,7106,7328,14640,-222,0.485382514,0.500546448,-0.015163934
Mississippi,28115,Pontotoc County,11425,2580,14215,8845,0.803728456,0.181498417,0.622230039
Mississippi,28117,Prentiss County,8274,2128,10539,6146,0.785083974,0.20191669,0.583167283
Mississippi,28119,Quitman County,1020,2138,3211,-1118,0.31765805,0.665836188,-0.348178138
Mississippi,28121,Rankin County,39025,13496,53400,25529,0.730805243,0.252734082,0.478071161
Mississippi,28123,Scott County,5688,3575,9386,2113,0.606008949,0.380886427,0.225122523
Mississippi,28125,Sharkey County,687,1440,2157,-753,0.318497914,0.66759388,-0.349095967
Mississippi,28127,Simpson County,6552,3384,10066,3168,0.650904033,0.336181204,0.314722829
Mississippi,28129,Smith County,5697,1518,7285,4179,0.782017845,0.20837337,0.573644475
Mississippi,28131,Stone County,5239,1208,6546,4031,0.800336083,0.184540177,0.615795906
Mississippi,28133,Sunflower County,2361,5118,7568,-2757,0.311971459,0.676268499,-0.36429704
Mississippi,28135,Tallahatchie County,2228,2636,4956,-408,0.449556094,0.531880549,-0.082324455
Mississippi,28137,Tate County,5529,2744,8420,2785,0.656650831,0.325890736,0.330760095
Mississippi,28139,Tippah County,7987,1906,10001,6081,0.798620138,0.190580942,0.608039196
Mississippi,28141,Tishomingo County,7854,1050,9057,6804,0.867174561,0.115932428,0.751242133
Mississippi,28143,Tunica County,912,2525,3494,-1613,0.26101889,0.72266743,-0.46164854
Mississippi,28145,Union County,9052,1792,10989,7260,0.823732824,0.163072163,0.660660661
Mississippi,28147,Walthall County,3426,2236,0,0,NaN,NaN,NaN
Mississippi,28149,Warren County,10236,10681,21162,-445,0.483697193,0.504725451,-0.021028258
Mississippi,28151,Washington County,4114,6218,10514,-2104,0.391287807,0.59140194,-0.200114134
Mississippi,28153,Wayne County,6264,3592,9988,2672,0.627152583,0.359631558,0.267521025
Mississippi,28155,Webster County,4255,1024,5347,3231,0.795773331,0.191509258,0.604264073
Mississippi,28157,Wilkinson County,1188,2364,3606,-1176,0.329450915,0.655574043,-0.326123128
Mississippi,28159,Winston County,5084,4009,9184,1075,0.553571429,0.436520035,0.117051394
Mississippi,28161,Yalobusha County,3658,2767,6506,891,0.562250231,0.425299723,0.136950507
Mississippi,28163,Yazoo County,4370,4533,9012,-163,0.48490901,0.502996005,-0.018086995
Missouri,29001,Adair County,6391,3705,10337,2686,0.618264487,0.358421205,0.259843281
Missouri,29003,Andrew County,7255,2351,9774,4904,0.742275425,0.240536116,0.501739308
Missouri,29005,Atchison County,2199,564,2814,1635,0.781449893,0.200426439,0.581023454
Missouri,29007,Audrain County,7727,2703,10660,5024,0.724859287,0.253564728,0.471294559
Missouri,29009,Barry County,12425,2948,15616,9477,0.795658299,0.188780738,0.606877561
Missouri,29011,Barton County,5168,844,6077,4324,0.850419615,0.138884318,0.711535297
Missouri,29013,Bates County,6595,1672,8435,4923,0.781861292,0.198221695,0.583639597
Missouri,29015,Benton County,8106,2179,10478,5927,0.77362092,0.207959534,0.565661386
Missouri,29017,Bollinger County,5162,749,5981,4413,0.863066377,0.125229895,0.737836482
Missouri,29019,Boone County,38596,49999,91200,-11403,0.423201754,0.548234649,-0.125032895
Missouri,29021,Buchanan County,22450,13445,36713,9005,0.611500014,0.36621905,0.245280963
Missouri,29023,Butler County,14599,3301,18165,11298,0.803688412,0.181723094,0.621965318
Missouri,29025,Caldwell County,3725,897,4696,2828,0.793228279,0.191013629,0.602214651
Missouri,29027,Callaway County,14812,5868,21178,8944,0.699405043,0.277079989,0.422325054
Missouri,29029,Camden County,18825,5640,24774,13185,0.759869218,0.227658029,0.532211189
Missouri,29031,Cape Girardeau County,28873,10738,40252,18135,0.717305972,0.266769353,0.450536619
Missouri,29033,Carroll County,3706,785,4531,2921,0.817920989,0.173250938,0.644670051
Missouri,29035,Carter County,2451,418,2906,2033,0.843427392,0.14384033,0.699587061
Missouri,29037,Cass County,37172,19035,57524,18137,0.646199847,0.330905361,0.315294486
Missouri,29039,Cedar County,5786,1143,7039,4643,0.82199176,0.16238102,0.65961074
Missouri,29041,Chariton County,3109,916,4074,2193,0.763132057,0.224840452,0.538291605
Missouri,29043,Christian County,34904,11126,46904,23778,0.744158281,0.237207914,0.506950367
Missouri,29045,Clark County,2672,678,3394,1994,0.787271656,0.19976429,0.587507366
Missouri,29047,Clay County,64583,59519,126618,5064,0.510061761,0.470067447,0.039994314
Missouri,29049,Clinton County,7789,2894,10894,4895,0.714980723,0.265650817,0.449329906
Missouri,29051,Cole County,26066,12687,39486,13379,0.660132705,0.321303753,0.338828952
Missouri,29053,Cooper County,6272,2249,8710,4023,0.720091848,0.258208955,0.461882893
Missouri,29055,Crawford County,8725,2113,10973,6612,0.79513351,0.192563565,0.602569944
Missouri,29057,Dade County,3414,656,4123,2758,0.828037837,0.159107446,0.66893039
Missouri,29059,Dallas County,6620,1380,8122,5240,0.81507018,0.169908889,0.64516129
Missouri,29061,Daviess County,3077,740,3884,2337,0.792224511,0.190525232,0.601699279
Missouri,29063,DeKalb County,3827,930,4842,2897,0.790375878,0.192069393,0.598306485
Missouri,29065,Dent County,5987,1056,7142,4931,0.838280594,0.147857743,0.690422851
Missouri,29067,Douglas County,5896,1012,6994,4884,0.843008293,0.144695453,0.69831284
Missouri,29069,Dunklin County,8135,2200,10419,5935,0.780785104,0.211152702,0.569632402
Missouri,29071,Franklin County,38034,14561,53750,23473,0.707609302,0.270902326,0.436706977
Missouri,29073,Gasconade County,6222,1601,7934,4621,0.784219813,0.201789766,0.582430048
Missouri,29075,Gentry County,2580,613,3239,1967,0.796542143,0.189255943,0.607286199
Missouri,29077,Greene County,81312,53307,138074,28005,0.588901603,0.386075583,0.202826021
Missouri,29079,Grundy County,3585,799,4437,2786,0.807978364,0.180076628,0.627901735
Missouri,29081,Harrison County,3198,597,3825,2601,0.836078431,0.156078431,0.68
Missouri,29083,Henry County,8019,2615,10776,5404,0.744153675,0.242668894,0.501484781
Missouri,29085,Hickory County,3965,1054,5080,2911,0.780511811,0.207480315,0.573031496
Missouri,29087,Holt County,1976,338,2343,1638,0.84336321,0.144259496,0.699103713
Missouri,29089,Howard County,3552,1412,5089,2140,0.697976027,0.277461191,0.420514836
Missouri,29091,Howell County,15174,3214,18637,11960,0.814186833,0.172452648,0.641734185
Missouri,29093,Iron County,3596,945,4592,2651,0.783101045,0.205792683,0.577308362
Missouri,29095,Jackson County,125897,198031,330771,-72134,0.380616801,0.59869517,-0.218078368
Missouri,29097,Jasper County,37714,13539,52515,24175,0.718156717,0.257812054,0.460344663
Missouri,29099,Jefferson County,77021,37507,116629,39514,0.660393213,0.3215924,0.338800813
Missouri,29101,Johnson County,15468,6961,23134,8507,0.668626264,0.30089911,0.367727155
Missouri,29103,Knox County,1486,340,1856,1146,0.800646552,0.183189655,0.617456897
Missouri,29105,Laclede County,13755,2779,16819,10976,0.817825079,0.1652298,0.652595279
Missouri,29107,Lafayette County,12262,4470,17083,7792,0.717789615,0.261663642,0.456125973
Missouri,29109,Lawrence County,14421,3214,17930,11207,0.804294479,0.179252649,0.625041829
Missouri,29111,Lewis County,3541,984,4607,2557,0.76861298,0.213588018,0.555024962
Missouri,29113,Lincoln County,21702,6553,28814,15149,0.75317554,0.227424169,0.525751371
Missouri,29115,Linn County,4344,1274,5700,3070,0.762105263,0.223508772,0.538596491
Missouri,29117,Livingston County,5266,1409,6755,3857,0.779570688,0.208586232,0.570984456
Missouri,29119,McDonald County,7465,1437,9051,6028,0.824770744,0.158766987,0.666003756
Missouri,29121,Macon County,6075,1661,7834,4414,0.775465918,0.212024509,0.563441409
Missouri,29123,Madison County,4581,1017,5671,3564,0.80779404,0.179333451,0.628460589
Missouri,29125,Maries County,3890,814,4774,3076,0.814830331,0.170506912,0.644323419
Missouri,29127,Marion County,9910,3201,13370,6709,0.741211668,0.239416604,0.501795064
Missouri,29129,Mercer County,1541,222,1779,1319,0.866216976,0.124789207,0.741427768
Missouri,29131,Miller County,10175,2038,12379,8137,0.821956539,0.164633654,0.657322886
Missouri,29133,Mississippi County,3537,1178,4756,2359,0.743692178,0.247687132,0.496005046
Missouri,29135,Moniteau County,5738,1307,7150,4431,0.802517483,0.182797203,0.61972028
Missouri,29137,Monroe County,3466,931,4469,2535,0.775565003,0.20832401,0.567240994
Missouri,29139,Montgomery County,4457,1206,5770,3251,0.772443674,0.209012132,0.563431542
Missouri,29141,Morgan County,7439,1924,9484,5515,0.784373682,0.202867988,0.581505694
Missouri,29143,New Madrid County,5447,1748,7248,3699,0.75151766,0.241169978,0.510347682
Missouri,29145,Newton County,22090,5793,28396,16297,0.777926469,0.204007607,0.573918862
Missouri,29147,Nodaway County,6855,2849,9874,4006,0.694247519,0.288535548,0.405711971
Missouri,29149,Oregon County,3847,823,4742,3024,0.811261071,0.173555462,0.637705609
Missouri,29151,Osage County,6341,1031,7449,5310,0.851255202,0.13840784,0.712847362
Missouri,29153,Ozark County,4064,752,4870,3312,0.83449692,0.154414784,0.680082136
Missouri,29155,Pemiscot County,4116,1556,5727,2560,0.718700891,0.271695478,0.447005413
Missouri,29157,Perry County,7634,1661,9429,5973,0.809629865,0.176158659,0.633471206
Missouri,29159,Pettis County,13835,4776,19069,9059,0.7255231,0.25045886,0.47506424
Missouri,29161,Phelps County,13438,5619,19531,7819,0.688034407,0.287696483,0.400337924
Missouri,29163,Pike County,5856,1717,7686,4139,0.761904762,0.223393182,0.538511579
Missouri,29165,Platte County,29251,28111,58523,1140,0.499820583,0.480341062,0.019479521
Missouri,29167,Polk County,11849,2883,15059,8966,0.786838435,0.191446975,0.59539146
Missouri,29169,Pulaski County,10326,3735,14419,6591,0.716138428,0.25903322,0.457105208
Missouri,29171,Putnam County,1984,361,2361,1623,0.840321898,0.152901313,0.687420584
Missouri,29173,Ralls County,4396,1205,5662,3191,0.776404097,0.212822324,0.563581773
Missouri,29175,Randolph County,8018,2485,10742,5533,0.746415937,0.231334947,0.515080991
Missouri,29177,Ray County,8328,3107,11654,5221,0.714604428,0.266603741,0.448000686
Missouri,29179,Reynolds County,2733,529,3298,2204,0.828684051,0.160400243,0.668283808
Missouri,29181,Ripley County,4838,833,5743,4005,0.842416855,0.145046143,0.697370712
Missouri,29183,St. Charles County,128193,89346,222175,38847,0.576991111,0.402142455,0.174848655
Missouri,29185,St. Clair County,3930,988,4972,2942,0.790426388,0.198712792,0.591713596
Missouri,29186,Ste. Genevieve County,6627,2713,9495,3914,0.697946288,0.285729331,0.412216956
Missouri,29187,St. Francois County,20506,7044,27996,13462,0.73246178,0.251607372,0.480854408
Missouri,29189,St. Louis County,196808,322802,528107,-125994,0.372666903,0.611243555,-0.238576652
Missouri,29195,Saline County,6447,2903,9528,3544,0.67663728,0.30468094,0.371956339
Missouri,29197,Schuyler County,1606,373,2005,1233,0.800997506,0.186034913,0.614962594
Missouri,29199,Scotland County,1560,387,1985,1173,0.785894207,0.194962217,0.59093199
Missouri,29201,Scott County,13769,3753,17748,10016,0.775805725,0.211460446,0.564345278
Missouri,29203,Shannon County,3164,706,3908,2458,0.80962129,0.180655067,0.628966223
Missouri,29205,Shelby County,2700,592,3356,2108,0.804529201,0.176400477,0.628128725
Missouri,29207,Stoddard County,11460,1814,13410,9646,0.85458613,0.135272185,0.719313945
Missouri,29209,Stone County,14716,3486,18378,11230,0.800740015,0.189683317,0.611056698
Missouri,29211,Sullivan County,1974,478,2471,1496,0.798866856,0.19344395,0.605422906
Missouri,29213,Taney County,20426,5325,26240,15101,0.778429878,0.202934451,0.575495427
Missouri,29215,Texas County,9478,1716,11332,7762,0.836392517,0.15142958,0.684962937
Missouri,29217,Vernon County,7135,1902,9164,5233,0.778590135,0.207551288,0.571038848
Missouri,29219,Warren County,13222,4769,18373,8453,0.719642954,0.259565667,0.460077287
Missouri,29221,Washington County,8046,1804,9972,6242,0.806859206,0.180906538,0.625952667
Missouri,29223,Wayne County,4984,844,5874,4140,0.848484848,0.143684031,0.704800817
Missouri,29225,Webster County,14874,3572,18776,11302,0.792181508,0.190242863,0.601938645
Missouri,29227,Worth County,877,215,1107,662,0.792231256,0.194218609,0.598012647
Missouri,29229,Wright County,7452,1167,8741,6285,0.852534035,0.133508752,0.719025283
Missouri,29510,St. Louis city,21185,108385,131876,-87200,0.160643332,0.821870545,-0.661227213
Montana,30001,Beaverhead County,3923,1608,5661,2315,0.692987105,0.284048755,0.40893835
Montana,30003,Big Horn County,2185,2401,4669,-216,0.467980296,0.514242879,-0.046262583
Montana,30005,Blaine County,1469,1589,3121,-120,0.470682474,0.509131689,-0.038449215
Montana,30007,Broadwater County,3139,830,4056,2309,0.773915187,0.204635108,0.569280079
Montana,30009,Carbon County,4424,2412,7045,2012,0.627963094,0.342370476,0.285592619
Montana,30011,Carter County,775,74,864,701,0.896990741,0.085648148,0.811342593
Montana,30013,Cascade County,23199,15384,39688,7815,0.584534368,0.387623463,0.196910905
Montana,30015,Chouteau County,1888,988,2967,900,0.636332996,0.332996293,0.303336704
Montana,30017,Custer County,4204,1510,5878,2694,0.715209255,0.256890099,0.458319156
Montana,30019,Daniels County,799,195,1014,604,0.787968442,0.192307692,0.59566075
Montana,30021,Dawson County,3758,962,4837,2796,0.776927848,0.198883606,0.578044242
Montana,30023,Deer Lodge County,2184,2562,4888,-378,0.446808511,0.524140753,-0.077332242
Montana,30025,Fallon County,1375,172,1575,1203,0.873015873,0.109206349,0.763809524
Montana,30027,Fergus County,4830,1491,6487,3339,0.744566055,0.229844304,0.514721751
Montana,30029,Flathead County,38233,20238,60132,17995,0.635817867,0.336559569,0.299258298
Montana,30031,Gallatin County,31639,36964,71363,-5325,0.443352998,0.517971498,-0.0746185
Montana,30033,Garfield County,764,41,813,723,0.939729397,0.050430504,0.889298893
Montana,30035,Glacier County,1882,3603,5630,-1721,0.334280639,0.639964476,-0.305683837
Montana,30037,Golden Valley County,414,78,503,336,0.82306163,0.155069583,0.667992048
Montana,30039,Granite County,1419,638,2102,781,0.675071361,0.303520457,0.371550904
Montana,30041,Hill County,3952,2972,7167,980,0.551416213,0.414678387,0.136737826
Montana,30043,Jefferson County,5345,2625,8191,2720,0.652545477,0.320473691,0.332071786
Montana,30045,Judith Basin County,1040,275,1344,765,0.773809524,0.204613095,0.569196429
Montana,30047,Lake County,9319,6911,16617,2408,0.560811217,0.41589938,0.144911837
Montana,30049,Lewis and Clark County,21407,19741,42481,1666,0.503919399,0.464701867,0.039217533
Montana,30051,Liberty County,821,249,1083,572,0.758079409,0.229916898,0.528162512
Montana,30053,Lincoln County,8516,2812,11564,5704,0.736423383,0.243168454,0.493254929
Montana,30055,McCone County,956,155,1128,801,0.84751773,0.137411348,0.710106383
Montana,30057,Madison County,4186,1770,6107,2416,0.685442934,0.289831341,0.395611593
Montana,30059,Meagher County,833,258,1110,575,0.75045045,0.232432432,0.518018018
Montana,30061,Mineral County,1828,686,2562,1142,0.713505074,0.267759563,0.445745511
Montana,30063,Missoula County,26336,43351,71969,-17015,0.365935333,0.60235657,-0.236421237
Montana,30065,Musselshell County,2423,413,2881,2010,0.841027421,0.143353002,0.697674419
Montana,30067,Park County,6022,5277,11612,745,0.518601447,0.454443679,0.064157768
Montana,30069,Petroleum County,298,39,351,259,0.849002849,0.111111111,0.737891738
Montana,30071,Phillips County,1936,414,2384,1522,0.812080537,0.173657718,0.638422819
Montana,30073,Pondera County,2030,903,2994,1127,0.678022712,0.301603206,0.376419506
Montana,30075,Powder River County,970,154,1136,816,0.853873239,0.13556338,0.718309859
Montana,30077,Powell County,2347,752,3187,1595,0.736429244,0.235958582,0.500470662
Montana,30079,Prairie County,603,126,744,477,0.810483871,0.169354839,0.641129032
Montana,30081,Ravalli County,19103,8757,28490,10346,0.670515971,0.307371007,0.363144963
Montana,30083,Richland County,4792,874,5789,3918,0.827776818,0.150975989,0.676800829
Montana,30085,Roosevelt County,1991,1902,4015,89,0.495890411,0.473723537,0.022166874
Montana,30087,Rosebud County,2485,1199,3782,1286,0.657059757,0.317028027,0.340031729
Montana,30089,Sanders County,5660,1819,7651,3841,0.739772579,0.2377467,0.502025879
Montana,30091,Sheridan County,1402,574,2029,828,0.690980779,0.282897979,0.408082799
Montana,30093,Silver Bow County,7790,10442,18973,-2652,0.410583461,0.550361039,-0.139777579
Montana,30095,Stillwater County,4430,1155,5707,3275,0.776239706,0.202383038,0.573856667
Montana,30097,Sweet Grass County,1840,549,2446,1291,0.752248569,0.224448078,0.527800491
Montana,30099,Teton County,2608,1007,3695,1601,0.705818674,0.272530447,0.433288227
Montana,30101,Toole County,1596,467,2123,1129,0.751766368,0.219971738,0.53179463
Montana,30103,Treasure County,373,78,460,295,0.810869565,0.169565217,0.641304348
Montana,30105,Valley County,3135,1030,4272,2105,0.733848315,0.241104869,0.492743446
Montana,30107,Wheatland County,823,225,1068,598,0.770599251,0.210674157,0.559925094
Montana,30109,Wibaux County,516,77,598,439,0.862876254,0.128762542,0.734113712
Montana,30111,Yellowstone County,49548,29936,82217,19612,0.602649087,0.364109612,0.238539475
Nebraska,31001,Adams County,10085,4213,14650,5872,0.688395904,0.287576792,0.400819113
Nebraska,31003,Antelope County,3093,452,3583,2641,0.863243092,0.12615127,0.737091822
Nebraska,31005,Arthur County,260,21,284,239,0.915492958,0.073943662,0.841549296
Nebraska,31007,Banner County,362,43,410,319,0.882926829,0.104878049,0.77804878
Nebraska,31009,Blaine County,280,35,317,245,0.883280757,0.110410095,0.772870662
Nebraska,31011,Boone County,2653,499,3217,2154,0.82468138,0.15511346,0.66956792
Nebraska,31013,Box Butte County,4002,1051,5181,2951,0.772437753,0.202856591,0.569581162
Nebraska,31015,Boyd County,1010,135,1153,875,0.875975716,0.117085863,0.758889853
Nebraska,31017,Brown County,1468,190,1676,1278,0.875894988,0.113365155,0.762529833
Nebraska,31019,Buffalo County,16473,6292,23474,10181,0.701755133,0.268041237,0.433713896
Nebraska,31021,Burt County,2560,1061,3709,1499,0.690212995,0.286060933,0.404152063
Nebraska,31023,Butler County,3526,869,4478,2657,0.787405092,0.194059848,0.593345243
Nebraska,31025,Cass County,10121,4737,15318,5384,0.660725943,0.309244027,0.351481917
Nebraska,31027,Cedar County,4174,725,4996,3449,0.835468375,0.145116093,0.690352282
Nebraska,31029,Chase County,1740,226,1993,1514,0.873055695,0.113396889,0.759658806
Nebraska,31031,Cherry County,2844,373,3265,2471,0.871056662,0.11424196,0.756814701
Nebraska,31033,Cheyenne County,3813,855,4765,2958,0.800209864,0.179433368,0.620776495
Nebraska,31035,Clay County,2848,632,3558,2216,0.800449691,0.177627881,0.62282181
Nebraska,31037,Colfax County,2635,1024,3724,1611,0.707572503,0.274973147,0.432599356
Nebraska,31039,Cuming County,3476,862,4412,2614,0.787851315,0.195376247,0.592475068
Nebraska,31041,Custer County,4996,768,5877,4228,0.850093585,0.130678918,0.719414667
Nebraska,31043,Dakota County,3926,2744,6794,1182,0.57786282,0.403885782,0.173977039
Nebraska,31045,Dawes County,2919,1076,4102,1843,0.711604096,0.262311068,0.449293028
Nebraska,31047,Dawson County,6524,2497,9191,4027,0.709824829,0.271678816,0.438146012
Nebraska,31049,Deuel County,901,153,1082,748,0.83271719,0.141404806,0.691312384
Nebraska,31051,Dixon County,2335,651,3083,1684,0.757379176,0.211157963,0.546221213
Nebraska,31053,Dodge County,10963,5526,16880,5437,0.649466825,0.327369668,0.322097156
Nebraska,31055,Douglas County,116696,146433,269960,-29737,0.432271448,0.542424804,-0.110153356
Nebraska,31057,Dundy County,883,105,999,778,0.883883884,0.105105105,0.778778779
Nebraska,31059,Fillmore County,2359,693,3134,1666,0.752712189,0.221123165,0.531589024
Nebraska,31061,Franklin County,1434,276,1721,1158,0.83323649,0.160371877,0.672864614
Nebraska,31063,Frontier County,1229,189,1440,1040,0.853472222,0.13125,0.722222222
Nebraska,31065,Furnas County,2163,399,2601,1764,0.83160323,0.153402537,0.678200692
Nebraska,31067,Gage County,7445,3385,11068,4060,0.67265992,0.305836646,0.366823274
Nebraska,31069,Garden County,1016,161,1195,855,0.850209205,0.134728033,0.715481172
Nebraska,31071,Garfield County,925,133,1067,792,0.866916589,0.124648547,0.742268041
Nebraska,31073,Gosper County,893,215,1118,678,0.798747764,0.192307692,0.606440072
Nebraska,31075,Grant County,375,20,402,355,0.932835821,0.049751244,0.883084577
Nebraska,31077,Greeley County,1016,229,1258,787,0.807631161,0.182034976,0.625596184
Nebraska,31079,Hall County,15950,7551,23999,8399,0.664611025,0.31463811,0.349972916
Nebraska,31081,Hamilton County,4297,1117,5520,3180,0.778442029,0.202355072,0.576086957
Nebraska,31083,Harlan County,1615,282,1928,1333,0.837655602,0.14626556,0.691390041
Nebraska,31085,Hayes County,492,34,532,458,0.92481203,0.063909774,0.860902256
Nebraska,31087,Hitchcock County,1260,174,1464,1086,0.860655738,0.118852459,0.741803279
Nebraska,31089,Holt County,4766,683,5531,4083,0.861688664,0.123485807,0.738202857
Nebraska,31091,Hooker County,376,59,442,317,0.850678733,0.133484163,0.71719457
Nebraska,31093,Howard County,2786,648,3501,2138,0.795772636,0.185089974,0.610682662
Nebraska,31095,Jefferson County,2593,1009,3686,1584,0.703472599,0.27373847,0.429734129
Nebraska,31097,Johnson County,1517,646,2227,871,0.681185451,0.290076336,0.391109115
Nebraska,31099,Kearney County,2812,699,3591,2113,0.783068783,0.1946533,0.588415483
Nebraska,31101,Keith County,3544,763,4364,2781,0.812098992,0.174839597,0.637259395
Nebraska,31103,Keya Paha County,476,49,529,427,0.899810964,0.092627599,0.807183365
Nebraska,31105,Kimball County,1553,267,1860,1286,0.834946237,0.143548387,0.691397849
Nebraska,31107,Knox County,3719,903,4693,2816,0.792456851,0.192414234,0.600042617
Nebraska,31109,Lancaster County,68321,80513,153031,-12192,0.446452026,0.526122158,-0.079670132
Nebraska,31111,Lincoln County,13071,3692,17151,9379,0.762112996,0.215264416,0.54684858
Nebraska,31113,Logan County,407,38,450,369,0.904444444,0.084444444,0.82
Nebraska,31115,Loup County,370,75,454,295,0.814977974,0.165198238,0.649779736
Nebraska,31117,McPherson County,275,17,302,258,0.910596026,0.056291391,0.854304636
Nebraska,31119,Madison County,11678,3393,15407,8285,0.757967158,0.220224573,0.537742585
Nebraska,31121,Merrick County,3407,740,4267,2667,0.798453246,0.173423951,0.625029295
Nebraska,31123,Morrill County,2113,386,2558,1727,0.826035966,0.15089914,0.675136826
Nebraska,31125,Nance County,1437,359,1828,1078,0.786105033,0.196389497,0.589715536
Nebraska,31127,Nemaha County,2428,921,3423,1507,0.709319311,0.269062226,0.440257084
Nebraska,31129,Nuckolls County,1850,409,2296,1441,0.805749129,0.178135889,0.62761324
Nebraska,31131,Otoe County,5609,2481,8306,3128,0.675294967,0.298699735,0.376595232
Nebraska,31133,Pawnee County,1071,322,1429,749,0.749475157,0.2253324,0.524142757
Nebraska,31135,Perkins County,1321,199,1545,1122,0.855016181,0.128802589,0.726213592
Nebraska,31137,Phelps County,4157,752,5009,3405,0.829906169,0.150129766,0.679776402
Nebraska,31139,Pierce County,3462,480,4006,2982,0.864203694,0.11982027,0.744383425
Nebraska,31141,Platte County,11827,3208,15256,8619,0.775235973,0.210277923,0.564958049
Nebraska,31143,Polk County,2286,527,2870,1759,0.796515679,0.183623693,0.612891986
Nebraska,31145,Red Willow County,4525,811,5452,3714,0.829970653,0.148752751,0.681217902
Nebraska,31147,Richardson County,2981,981,4018,2000,0.741911399,0.244151319,0.49776008
Nebraska,31149,Rock County,744,84,841,660,0.884661118,0.099881094,0.784780024
Nebraska,31151,Saline County,3458,1737,5336,1721,0.648050975,0.325524738,0.322526237
Nebraska,31153,Sarpy County,51518,41029,95409,10489,0.539970024,0.430032806,0.109937218
Nebraska,31155,Saunders County,9036,3318,12646,5718,0.71453424,0.262375455,0.452158785
Nebraska,31157,Scotts Bluff County,10810,4133,15289,6677,0.70704428,0.27032507,0.43671921
Nebraska,31159,Seward County,6490,2438,9142,4052,0.709910304,0.266681251,0.443229053
Nebraska,31161,Sheridan County,2292,340,2672,1952,0.857784431,0.127245509,0.730538922
Nebraska,31163,Sherman County,1306,341,1680,965,0.777380952,0.20297619,0.574404762
Nebraska,31165,Sioux County,642,72,729,570,0.880658436,0.098765432,0.781893004
Nebraska,31167,Stanton County,2561,532,3165,2029,0.809162717,0.168088468,0.64107425
Nebraska,31169,Thayer County,2285,619,2951,1666,0.774313792,0.209759404,0.564554388
Nebraska,31171,Thomas County,377,45,427,332,0.882903981,0.105386417,0.777517564
Nebraska,31173,Thurston County,1164,1107,2294,57,0.507410636,0.482563208,0.024847428
Nebraska,31175,Valley County,1892,410,2333,1482,0.810972996,0.175739391,0.635233605
Nebraska,31177,Washington County,8583,3554,12413,5029,0.691452509,0.286312737,0.405139773
Nebraska,31179,Wayne County,3055,1022,4200,2033,0.727380952,0.243333333,0.484047619
Nebraska,31181,Webster County,1511,335,1876,1176,0.8054371,0.178571429,0.626865672
Nebraska,31183,Wheeler County,438,59,502,379,0.87250996,0.11752988,0.75498008
Nebraska,31185,York County,5296,1619,7089,3677,0.74707293,0.228382,0.51869093
Nevada,32001,Churchill County,9088,2966,12503,6122,0.726865552,0.237223066,0.489642486
Nevada,32003,Clark County,379570,457312,852228,-77742,0.445385507,0.536607574,-0.091222067
Nevada,32005,Douglas County,21237,11390,33537,9847,0.633240898,0.339624892,0.293616006
Nevada,32007,Elko County,15726,4246,20575,11480,0.764325638,0.20636695,0.557958688
Nevada,32009,Esmeralda County,389,72,474,317,0.820675105,0.151898734,0.668776371
Nevada,32011,Eureka County,833,92,942,741,0.884288747,0.097664544,0.786624204
Nevada,32013,Humboldt County,5531,1608,7324,3923,0.755188422,0.219552157,0.535636264
Nevada,32015,Lander County,2110,478,2653,1632,0.795326046,0.180173389,0.615152657
Nevada,32017,Lincoln County,1949,318,2312,1631,0.84299308,0.137543253,0.705449827
Nevada,32019,Lyon County,20302,8264,29392,12038,0.690732172,0.281164943,0.409567229
Nevada,32021,Mineral County,1343,759,2179,584,0.61633777,0.34832492,0.26801285
Nevada,32023,Nye County,15791,6618,22857,9173,0.690860568,0.28953931,0.401321258
Nevada,32027,Pershing County,1668,525,2232,1143,0.747311828,0.235215054,0.512096774
Nevada,32029,Storey County,1905,899,2870,1006,0.663763066,0.313240418,0.350522648
Nevada,32031,Washoe County,113450,123690,244132,-10240,0.464707617,0.506652139,-0.041944522
Nevada,32033,White Pine County,3238,836,4177,2402,0.77519751,0.200143644,0.575053866
Nevada,32510,Carson City,15771,12485,29126,3286,0.541474971,0.42865481,0.112820161
New Hampshire,33001,Belknap County,20870,16857,38387,4013,0.54367364,0.43913304,0.1045406
New Hampshire,33003,Carroll County,16065,16618,33111,-553,0.485186192,0.50188759,-0.016701398
New Hampshire,33005,Cheshire County,17892,25502,44200,-7610,0.40479638,0.576968326,-0.172171946
New Hampshire,33007,Coos County,8611,7625,16507,986,0.521657479,0.461925244,0.059732235
New Hampshire,33009,Grafton County,19905,33180,53989,-13275,0.368686214,0.614569635,-0.245883421
New Hampshire,33011,Hillsborough County,104553,120032,230531,-15479,0.453531195,0.520676178,-0.067144983
New Hampshire,33013,Merrimack County,39518,48323,89477,-8805,0.441655397,0.540060574,-0.098405177
New Hampshire,33015,Rockingham County,95858,100064,198952,-4206,0.481814709,0.502955487,-0.021140778
New Hampshire,33017,Strafford County,30486,41693,73676,-11207,0.413784679,0.565896628,-0.15211195
New Hampshire,33019,Sullivan County,11490,12390,24365,-900,0.471578083,0.508516314,-0.036938231
New Jersey,34001,Atlantic County,60912,68933,131890,-8021,0.461839412,0.522655243,-0.060815831
New Jersey,34003,Bergen County,182831,259358,448647,-76527,0.407516377,0.578089233,-0.170572856
New Jersey,34005,Burlington County,79881,131202,214299,-51321,0.372754889,0.612238041,-0.239483152
New Jersey,34007,Camden County,62174,140026,205125,-77852,0.303102986,0.682637416,-0.37953443
New Jersey,34009,Cape May County,31498,22713,54980,8785,0.572899236,0.41311386,0.159785377
New Jersey,34011,Cumberland County,17387,22257,40103,-4870,0.433558587,0.554995886,-0.121437299
New Jersey,34013,Essex County,63971,224615,291105,-160644,0.219752323,0.771594442,-0.551842119
New Jersey,34015,Gloucester County,80700,84120,168093,-3420,0.480091378,0.500437258,-0.02034588
New Jersey,34017,Hudson County,45160,141997,189521,-96837,0.238284939,0.749241509,-0.510956569
New Jersey,34019,Hunterdon County,39751,37419,78998,2332,0.503189954,0.473670219,0.029519735
New Jersey,34021,Mercer County,45926,109514,158252,-63588,0.290208023,0.69202285,-0.401814827
New Jersey,34023,Middlesex County,70250,141256,213777,-71006,0.328613462,0.660763319,-0.332149857
New Jersey,34025,Monmouth County,142212,146893,292654,-4681,0.485939027,0.501934024,-0.015994998
New Jersey,34027,Morris County,63209,83266,148759,-20057,0.424908745,0.559737562,-0.134828817
New Jersey,34029,Ocean County,202449,112552,320036,89897,0.63258196,0.351685435,0.280896524
New Jersey,34031,Passaic County,53826,84346,139854,-30520,0.384872796,0.603100376,-0.21822758
New Jersey,34033,Salem County,16524,12786,29905,3738,0.552549741,0.427553921,0.12499582
New Jersey,34035,Somerset County,61074,97301,160774,-36227,0.379874855,0.605203578,-0.225328722
New Jersey,34037,Sussex County,38188,28728,68327,9460,0.558900581,0.420448725,0.138451857
New Jersey,34039,Union County,32427,88990,122777,-56563,0.264112985,0.724810021,-0.460697036
New Jersey,34041,Warren County,23806,19327,43985,4479,0.541229965,0.439399795,0.101830169
New Mexico,35001,Bernalillo County,115674,192042,315332,-76368,0.366832418,0.60901526,-0.242182842
New Mexico,35003,Catron County,1698,594,2325,1104,0.730322581,0.255483871,0.47483871
New Mexico,35005,Chaves County,15656,6381,22443,9275,0.697589449,0.284320278,0.413269171
New Mexico,35006,Cibola County,3962,4696,8839,-734,0.448240751,0.531281819,-0.083041068
New Mexico,35007,Colfax County,3271,2611,6016,660,0.543716755,0.434009309,0.109707447
New Mexico,35009,Curry County,10428,4300,15077,6128,0.691649532,0.285202627,0.406446906
New Mexico,35011,De Baca County,654,231,899,423,0.727474972,0.256952169,0.470522803
New Mexico,35013,DoÃ±a Ana County,32760,47919,82556,-15159,0.396821551,0.580442366,-0.183620815
New Mexico,35015,Eddy County,17454,5424,23222,12030,0.751614848,0.233571613,0.518043235
New Mexico,35017,Grant County,6553,7590,14435,-1037,0.453966055,0.525805334,-0.07183928
New Mexico,35019,Guadalupe County,912,1229,2179,-317,0.418540615,0.564020193,-0.145479578
New Mexico,35021,Harding County,319,179,505,140,0.631683168,0.354455446,0.277227723
New Mexico,35023,Hidalgo County,1105,812,1948,293,0.56724846,0.416837782,0.150410678
New Mexico,35025,Lea County,16531,4061,20918,12470,0.790276317,0.194139019,0.596137298
New Mexico,35027,Lincoln County,6942,3194,10306,3748,0.673588201,0.309916553,0.363671648
New Mexico,35028,Los Alamos County,4274,7549,12284,-3275,0.34793227,0.614539238,-0.266606968
New Mexico,35029,Luna County,4407,3564,8103,843,0.54387264,0.439837097,0.104035542
New Mexico,35031,McKinley County,7717,17826,26193,-10109,0.2946207,0.680563509,-0.385942809
New Mexico,35033,Mora County,902,1744,2683,-842,0.336190831,0.650018636,-0.313827805
New Mexico,35035,Otero County,14521,8483,23569,6038,0.616105902,0.359921931,0.25618397
New Mexico,35037,Quay County,2634,1170,3873,1464,0.680092951,0.302091402,0.378001549
New Mexico,35039,Rio Arriba County,5390,10896,16511,-5506,0.326449034,0.659923687,-0.333474653
New Mexico,35041,Roosevelt County,4634,1802,6608,2832,0.701271186,0.272699758,0.428571429
New Mexico,35043,Sandoval County,34063,40361,76215,-6298,0.446933018,0.52956767,-0.082634652
New Mexico,35045,San Juan County,32872,18076,52284,14796,0.628720067,0.345727182,0.282992885
New Mexico,35047,San Miguel County,3414,7869,11504,-4455,0.296766342,0.684022949,-0.387256606
New Mexico,35049,Santa Fe County,18236,61629,81213,-43393,0.224545331,0.758856341,-0.534311009
New Mexico,35051,Sierra County,3542,2265,5945,1277,0.595794786,0.380992431,0.214802355
New Mexico,35053,Socorro County,3255,3721,7159,-466,0.45467244,0.51976533,-0.06509289
New Mexico,35055,Taos County,3638,12816,16790,-9178,0.216676593,0.763311495,-0.546634902
New Mexico,35057,Torrance County,4772,2344,7281,2428,0.655404477,0.3219338,0.333470677
New Mexico,35059,Union County,1388,383,1789,1005,0.775852432,0.214086082,0.56176635
New Mexico,35061,Valencia County,17245,14051,31939,3194,0.539935502,0.439932371,0.100003131
New York,36001,Albany County,45570,73189,121529,-27619,0.374972229,0.602234858,-0.227262629
New York,36003,Allegany County,12670,4188,17271,8482,0.733599676,0.242487407,0.491112269
New York,36005,Bronx County,55849,271835,329638,-215986,0.169425248,0.824647037,-0.655221789
New York,36007,Broome County,38296,32209,72251,6087,0.530041107,0.445793138,0.084247969
New York,36009,Cattaraugus County,20295,9142,30051,11153,0.675351902,0.304216166,0.371135736
New York,36011,Cayuga County,17639,11993,30296,5646,0.582222076,0.39586084,0.186361236
New York,36013,Chautauqua County,31247,16200,48428,15047,0.645225902,0.334517221,0.310708681
New York,36015,Chemung County,19388,11573,31646,7815,0.612652468,0.365701826,0.246950641
New York,36017,Chenango County,11736,5126,17241,6610,0.680702975,0.297314541,0.383388435
New York,36019,Clinton County,14354,12690,27471,1664,0.522514652,0.461941684,0.060572968
New York,36021,Columbia County,12883,14148,27537,-1265,0.467843265,0.513781458,-0.045938192
New York,36023,Cortland County,9484,6829,16700,2655,0.567904192,0.408922156,0.158982036
New York,36025,Delaware County,11952,6420,18763,5532,0.636998348,0.342162767,0.294835581
New York,36027,Dutchess County,59661,57720,119539,1941,0.499092346,0.482854968,0.016237379
New York,36029,Erie County,178349,198808,383952,-20459,0.464508584,0.517793891,-0.053285306
New York,36031,Essex County,7953,6970,15185,983,0.523740533,0.459005598,0.064734936
New York,36033,Franklin County,8530,6586,15397,1944,0.554004027,0.427745665,0.126258362
New York,36035,Fulton County,13989,5804,20153,8185,0.69413983,0.287996824,0.406143006
New York,36037,Genesee County,17340,7048,25004,10292,0.693489042,0.2818749,0.411614142
New York,36039,Greene County,12722,7675,20882,5047,0.609232832,0.367541423,0.241691409
New York,36041,Hamilton County,1917,863,2825,1054,0.678584071,0.305486726,0.373097345
New York,36043,Herkimer County,17038,7282,24766,9756,0.687959299,0.294032141,0.393927158
New York,36045,Jefferson County,22779,12053,35530,10726,0.64112018,0.33923445,0.30188573
New York,36047,Kings County,174731,514133,693937,-339402,0.251796633,0.740892905,-0.489096272
New York,36049,Lewis County,7931,2768,10878,5163,0.729086229,0.25445854,0.474627689
New York,36051,Livingston County,16575,9150,26333,7425,0.629438347,0.347472753,0.281965595
New York,36053,Madison County,16553,10417,27698,6136,0.597624377,0.376092137,0.221532241
New York,36055,Monroe County,122995,146403,276241,-23408,0.445245275,0.529982877,-0.084737602
New York,36057,Montgomery County,11500,5746,17615,5754,0.652852682,0.326199262,0.32665342
New York,36059,Nassau County,286661,280288,572706,6373,0.500537798,0.489409924,0.011127874
New York,36061,New York County,65001,377605,446861,-312604,0.14546134,0.845016683,-0.699555343
New York,36063,Niagara County,51355,34809,87821,16546,0.584769019,0.396363057,0.188405962
New York,36065,Oneida County,51950,30542,84099,21408,0.617724349,0.36316722,0.254557129
New York,36067,Onondaga County,78994,93850,176798,-14856,0.446803697,0.530831797,-0.0840281
New York,36069,Ontario County,25757,20779,47830,4978,0.538511395,0.434434455,0.104076939
New York,36071,Orange County,76218,61868,139956,14350,0.544585441,0.442053217,0.102532224
New York,36073,Orleans County,11173,4082,15625,7091,0.715072,0.261248,0.453824
New York,36075,Oswego County,28914,14677,44546,14237,0.649081848,0.329479639,0.319602209
New York,36077,Otsego County,12682,9138,22340,3544,0.567681289,0.409042077,0.158639212
New York,36079,Putnam County,25899,17106,43661,8793,0.593183848,0.391791301,0.201392547
New York,36081,Queens County,173304,769135,946572,-595831,0.183085914,0.812547804,-0.62946189
New York,36083,Rensselaer County,33371,30450,65285,2921,0.511158765,0.466416482,0.044742284
New York,36085,Richmond County,110094,67223,178751,42871,0.615907044,0.376070623,0.23983642
New York,36087,Rockland County,63830,50926,116024,12904,0.550144798,0.438926429,0.111218369
New York,36089,St. Lawrence County,21862,13036,35519,8826,0.615501563,0.367014837,0.248486725
New York,36091,Saratoga County,55248,49697,107583,5551,0.513538384,0.461941013,0.051597371
New York,36093,Schenectady County,27544,31685,60591,-4141,0.454588965,0.522932449,-0.068343483
New York,36095,Schoharie County,9010,4006,13374,5004,0.67369523,0.299536414,0.374158816
New York,36097,Schuyler County,5181,2858,8220,2323,0.630291971,0.347688564,0.282603406
New York,36099,Seneca County,7582,5076,12954,2506,0.585301837,0.391848078,0.193453759
New York,36101,Steuben County,26781,11299,38797,15482,0.690285331,0.291233858,0.399051473
New York,36103,Suffolk County,333100,258007,598129,75093,0.556903277,0.431356781,0.125546496
New York,36105,Sullivan County,15555,10995,26931,4560,0.577587167,0.408265568,0.1693216
New York,36107,Tioga County,13292,6724,20555,6568,0.646655315,0.327122355,0.31953296
New York,36109,Tompkins County,8522,21643,30851,-13121,0.276230916,0.701533176,-0.425302259
New York,36111,Ulster County,33580,42606,77667,-9026,0.432358659,0.548572753,-0.116214094
New York,36113,Warren County,15200,11811,27625,3389,0.550226244,0.427547511,0.122678733
New York,36115,Washington County,14577,8537,23607,6040,0.617486339,0.361630025,0.255856314
New York,36117,Wayne County,23734,12799,37425,10935,0.634175017,0.341990648,0.292184369
New York,36119,Westchester County,217725,400881,625318,-183156,0.348182845,0.641083417,-0.292900572
New York,36121,Wyoming County,12969,3840,17162,9129,0.755681156,0.223750146,0.53193101
New York,36123,Yates County,5552,3046,8817,2506,0.629692639,0.34546898,0.284223659
North Carolina,37001,Alamance County,45490,38186,84710,7304,0.537008618,0.450785031,0.086223586
North Carolina,37003,Alexander County,15806,4113,20120,11693,0.785586481,0.204423459,0.581163022
North Carolina,37005,Alleghany County,4501,1480,6040,3021,0.745198675,0.245033113,0.500165563
North Carolina,37007,Anson County,5321,5788,11183,-467,0.4758115,0.517571314,-0.041759814
North Carolina,37009,Ashe County,11368,4149,15691,7219,0.724491747,0.264419094,0.460072653
North Carolina,37011,Avery County,7092,2171,9339,4921,0.759396081,0.232466003,0.526930078
North Carolina,37013,Beaufort County,16352,9575,26164,6777,0.62498089,0.365960862,0.259020028
North Carolina,37015,Bertie County,3778,5846,9680,-2068,0.390289256,0.60392562,-0.213636364
North Carolina,37017,Bladen County,9623,7281,17009,2342,0.565759304,0.428067494,0.13769181
North Carolina,37019,Brunswick County,55373,32984,89328,22389,0.619884023,0.369245925,0.250638098
North Carolina,37021,Buncombe County,61983,95881,160443,-33898,0.386324115,0.59760164,-0.211277525
North Carolina,37023,Burke County,30814,12985,44182,17829,0.697433344,0.293897967,0.403535376
North Carolina,37025,Cabarrus County,62974,51943,116722,11031,0.539521256,0.44501465,0.094506605
North Carolina,37027,Caldwell County,31877,10105,42438,21772,0.751142844,0.238112069,0.513030774
North Carolina,37029,Camden County,4277,1515,5879,2762,0.727504678,0.257696887,0.46980779
North Carolina,37031,Carteret County,29886,11999,42446,17887,0.704094614,0.282688593,0.421406022
North Carolina,37033,Caswell County,7040,4831,11962,2209,0.588530346,0.40386223,0.184668116
North Carolina,37035,Catawba County,56203,25420,82751,30783,0.679182125,0.30718662,0.371995505
North Carolina,37037,Chatham County,21055,26642,48308,-5587,0.435849135,0.551502857,-0.115653722
North Carolina,37039,Cherokee County,12568,3563,16341,9005,0.769108378,0.218040512,0.551067866
North Carolina,37041,Chowan County,4458,3232,7754,1226,0.574929069,0.416817127,0.158111942
North Carolina,37043,Clay County,5074,1685,6828,3389,0.743116579,0.246777973,0.496338606
North Carolina,37045,Cleveland County,33664,16879,51095,16785,0.65885116,0.330345435,0.328505725
North Carolina,37047,Columbus County,16696,9382,26243,7314,0.636207751,0.357504858,0.278702892
North Carolina,37049,Craven County,30831,20977,52675,9854,0.585306122,0.398234457,0.187071666
North Carolina,37051,Cumberland County,59498,83533,145598,-24035,0.408645723,0.57372354,-0.165077817
North Carolina,37053,Currituck County,11566,4151,16006,7415,0.722604023,0.259340247,0.463263776
North Carolina,37055,Dare County,13844,9855,24061,3989,0.575370932,0.409583974,0.165786958
North Carolina,37057,Davidson County,62143,21483,84785,40660,0.732948045,0.253382084,0.479565961
North Carolina,37059,Davie County,18115,6653,25059,11462,0.72289397,0.265493435,0.457400535
North Carolina,37061,Duplin County,13703,8676,22510,5027,0.608751666,0.385428698,0.223322968
North Carolina,37063,Durham County,31827,142770,177227,-110943,0.179583246,0.805577028,-0.625993782
North Carolina,37065,Edgecombe County,9162,16027,25344,-6865,0.361505682,0.632378472,-0.27087279
North Carolina,37067,Forsyth County,84176,111769,198469,-27593,0.42412669,0.563155959,-0.139029269
North Carolina,37069,Franklin County,20748,15776,37079,4972,0.559562016,0.425469943,0.134092074
North Carolina,37071,Gaston County,72132,40231,113791,31901,0.63389899,0.353551687,0.280347303
North Carolina,37073,Gates County,3354,2540,5944,814,0.564266487,0.427321669,0.136944818
North Carolina,37075,Graham County,3667,896,4606,2771,0.796135475,0.194528875,0.6016066
North Carolina,37077,Granville County,16548,14448,31316,2100,0.528419977,0.461361604,0.067058373
North Carolina,37079,Greene County,4858,3820,8715,1038,0.557429719,0.438324727,0.119104991
North Carolina,37081,Guilford County,106384,171538,281201,-65154,0.378320134,0.610019168,-0.231699034
North Carolina,37083,Halifax County,9973,15382,25485,-5409,0.391328232,0.603570728,-0.212242496
North Carolina,37085,Harnett County,34905,21839,57733,13066,0.60459356,0.378275856,0.226317704
North Carolina,37087,Haywood County,22698,13095,36265,9603,0.625892734,0.361091962,0.264800772
North Carolina,37089,Henderson County,39810,27014,67773,12796,0.587402063,0.398595311,0.188806752
North Carolina,37091,Hertford County,3470,7077,10590,-3607,0.327667611,0.668271955,-0.340604344
North Carolina,37093,Hoke County,9601,11929,21879,-2328,0.438822615,0.545226016,-0.106403401
North Carolina,37095,Hyde County,1408,1035,2470,373,0.570040486,0.41902834,0.151012146
North Carolina,37097,Iredell County,66439,33426,101276,33013,0.656019195,0.33004858,0.325970615
North Carolina,37099,Jackson County,11263,9522,21237,1741,0.530347978,0.448368414,0.081979564
North Carolina,37101,Johnston County,67901,40861,110246,27040,0.615904432,0.370634762,0.24526967
North Carolina,37103,Jones County,3267,2175,5484,1092,0.595733042,0.396608315,0.199124726
North Carolina,37105,Lee County,16388,12076,28851,4312,0.568021906,0.418564348,0.149457558
North Carolina,37107,Lenoir County,14500,13494,28177,1006,0.51460411,0.478901232,0.035702878
North Carolina,37109,Lincoln County,36167,13178,49850,22989,0.72551655,0.264353059,0.46116349
North Carolina,37111,McDowell County,16839,5807,22891,11032,0.735616618,0.253680486,0.481936132
North Carolina,37113,Macon County,14152,6213,20647,7939,0.685426454,0.300915387,0.384511067
North Carolina,37115,Madison County,7928,4878,13000,3050,0.609846154,0.375230769,0.234615385
North Carolina,37117,Martin County,6493,5876,12454,617,0.5213586,0.471816284,0.049542316
North Carolina,37119,Mecklenburg County,178066,375503,563218,-197437,0.316158219,0.666709871,-0.350551651
North Carolina,37121,Mitchell County,7041,1852,8960,5189,0.785825893,0.206696429,0.579129464
North Carolina,37123,Montgomery County,8363,4305,12779,4058,0.654433054,0.33688082,0.317552234
North Carolina,37125,Moore County,36459,20547,57771,15912,0.631095186,0.355662876,0.27543231
North Carolina,37127,Nash County,25653,25702,51826,-49,0.494983213,0.495928684,-0.000945471
North Carolina,37129,New Hanover County,62420,64876,129254,-2456,0.482925093,0.501926439,-0.019001346
North Carolina,37131,Northampton County,3977,6048,10075,-2071,0.394739454,0.600297767,-0.205558313
North Carolina,37133,Onslow County,45016,23474,70117,21542,0.642012636,0.334783291,0.307229345
North Carolina,37135,Orange County,19993,63097,84010,-43104,0.237983573,0.751065349,-0.513081776
North Carolina,37137,Pamlico County,4815,2699,7572,2116,0.635895404,0.356444797,0.279450608
North Carolina,37139,Pasquotank County,9626,9653,19512,-27,0.493337433,0.494721197,-0.001383764
North Carolina,37141,Pender County,21833,11655,33971,10178,0.64269524,0.34308675,0.29960849
North Carolina,37143,Perquimans County,4894,2485,7457,2409,0.656296098,0.333243932,0.323052166
North Carolina,37145,Person County,13104,8416,21737,4688,0.602843079,0.387173943,0.215669136
North Carolina,37147,Pitt County,38515,46607,86217,-8092,0.446721644,0.540577844,-0.0938562
North Carolina,37149,Polk County,7643,4485,12253,3158,0.623765608,0.366032808,0.2577328
North Carolina,37151,Randolph County,56589,15506,72788,41083,0.77744958,0.21302962,0.564419959
North Carolina,37153,Richmond County,11752,8676,20597,3076,0.570568529,0.421226392,0.149342137
North Carolina,37155,Robeson County,26012,18094,44384,7918,0.586067051,0.40766943,0.178397621
North Carolina,37157,Rockingham County,30997,15811,47241,15186,0.656146144,0.334688089,0.321458056
North Carolina,37159,Rowan County,49053,22889,72756,26164,0.674212436,0.314599483,0.359612953
North Carolina,37161,Rutherford County,24631,9049,34076,15582,0.722825449,0.265553469,0.45727198
North Carolina,37163,Sampson County,17330,10832,28394,6498,0.610340213,0.381489047,0.228851166
North Carolina,37165,Scotland County,7399,7137,14632,262,0.505672499,0.487766539,0.01790596
North Carolina,37167,Stanly County,25297,8037,33624,17260,0.752349512,0.239025696,0.513323816
North Carolina,37169,Stokes County,19997,5258,25525,14739,0.783428012,0.205994123,0.577433888
North Carolina,37171,Surry County,27344,8635,36290,18709,0.753485809,0.237944337,0.515541471
North Carolina,37173,Swain County,4152,2765,7026,1387,0.590947908,0.393538286,0.197409621
North Carolina,37175,Transylvania County,11578,8413,20253,3165,0.571668395,0.41539525,0.156273145
North Carolina,37177,Tyrrell County,1043,757,1812,286,0.575607064,0.417770419,0.157836645
North Carolina,37179,Union County,79778,48199,129475,31579,0.616165283,0.372264916,0.243900367
North Carolina,37181,Vance County,8385,12412,20948,-4027,0.400276876,0.592514799,-0.192237922
North Carolina,37183,Wake County,223466,388686,624049,-165220,0.35809047,0.622845321,-0.264754851
North Carolina,37185,Warren County,3739,6344,10207,-2605,0.366317233,0.621534241,-0.255217008
North Carolina,37187,Washington County,2778,3387,6191,-609,0.448715878,0.547084477,-0.0983686
North Carolina,37189,Watauga County,14332,16925,31771,-2593,0.451103207,0.532718517,-0.08161531
North Carolina,37191,Wayne County,30505,23986,55091,6519,0.553720208,0.43538872,0.118331488
North Carolina,37193,Wilkes County,27397,7445,35197,19952,0.778390204,0.211523709,0.566866494
North Carolina,37195,Wilson County,19473,20579,40446,-1106,0.481456757,0.508801859,-0.027345102
North Carolina,37197,Yadkin County,15861,3744,19794,12117,0.801303425,0.189148227,0.612155199
North Carolina,37199,Yancey County,7481,3678,11282,3803,0.66309165,0.326006027,0.337085623
North Dakota,38001,Adams County,978,258,1266,720,0.772511848,0.203791469,0.568720379
North Dakota,38003,Barnes County,3532,1800,5507,1732,0.641365535,0.326856728,0.314508807
North Dakota,38005,Benson County,1090,817,1952,273,0.558401639,0.418545082,0.139856557
North Dakota,38007,Billings County,539,72,633,467,0.85150079,0.113744076,0.737756714
North Dakota,38009,Bottineau County,2563,819,3456,1744,0.741608796,0.236979167,0.50462963
North Dakota,38011,Bowman County,1382,227,1643,1155,0.841144248,0.138161899,0.702982349
North Dakota,38013,Burke County,1022,196,1332,826,0.767267267,0.147147147,0.62012012
North Dakota,38015,Burleigh County,34588,14226,50465,20362,0.685385911,0.281898345,0.403487566
North Dakota,38017,Cass County,42567,40219,85906,2348,0.495506717,0.468174516,0.0273322
North Dakota,38019,Cavalier County,1499,474,2020,1025,0.742079208,0.234653465,0.507425743
North Dakota,38021,Dickey County,1732,602,2408,1130,0.719269103,0.25,0.469269103
North Dakota,38023,Divide County,899,265,1197,634,0.751044277,0.2213868,0.529657477
North Dakota,38025,Dunn County,1945,338,2328,1607,0.8354811,0.145189003,0.690292096
North Dakota,38027,Eddy County,851,382,1257,469,0.677008751,0.30389817,0.373110581
North Dakota,38029,Emmons County,1735,237,2006,1498,0.864905284,0.118145563,0.746759721
North Dakota,38031,Foster County,1338,369,1748,969,0.765446224,0.211098398,0.554347826
North Dakota,38033,Golden Valley County,870,136,1024,734,0.849609375,0.1328125,0.716796875
North Dakota,38035,Grand Forks County,16963,12856,30915,4107,0.548698043,0.415849911,0.132848132
North Dakota,38037,Grant County,1132,207,1367,925,0.82809071,0.151426481,0.676664228
North Dakota,38039,Griggs County,906,308,1248,598,0.725961538,0.246794872,0.479166667
North Dakota,38041,Hettinger County,1086,195,1306,891,0.831546708,0.149310873,0.682235835
North Dakota,38043,Kidder County,1206,221,1450,985,0.831724138,0.152413793,0.679310345
North Dakota,38045,LaMoure County,1633,526,2206,1107,0.740253853,0.238440617,0.501813237
North Dakota,38047,Logan County,923,125,1066,798,0.865853659,0.117260788,0.748592871
North Dakota,38049,McHenry County,2345,559,2974,1786,0.788500336,0.18796234,0.600537996
North Dakota,38051,McIntosh County,1147,259,1447,888,0.792674499,0.178991016,0.613683483
North Dakota,38053,McKenzie County,4476,813,5412,3663,0.827050998,0.150221729,0.676829268
North Dakota,38055,McLean County,4169,1216,5491,2953,0.759242397,0.221453287,0.537789109
North Dakota,38057,Mercer County,3850,703,4668,3147,0.824764353,0.150599829,0.674164524
North Dakota,38059,Morton County,12234,3865,16603,8369,0.736854785,0.232789255,0.50406553
North Dakota,38061,Mountrail County,2806,1251,4142,1555,0.677450507,0.302028006,0.375422501
North Dakota,38063,Nelson County,1139,585,1774,554,0.64205186,0.329763247,0.312288613
North Dakota,38065,Oliver County,917,127,1063,790,0.862652869,0.119473189,0.74317968
North Dakota,38067,Pembina County,2435,783,3303,1652,0.737208598,0.237057221,0.500151378
North Dakota,38069,Pierce County,1637,569,2378,1068,0.688393608,0.239276703,0.449116905
North Dakota,38071,Ramsey County,3570,1636,5362,1934,0.665796345,0.305110034,0.360686311
North Dakota,38073,Ransom County,1411,942,2443,469,0.577568563,0.385591486,0.191977077
North Dakota,38075,Renville County,1053,218,1305,835,0.806896552,0.167049808,0.639846743
North Dakota,38077,Richland County,5035,2495,7757,2540,0.649091143,0.321644966,0.327446178
North Dakota,38079,Rolette County,1253,2475,3791,-1222,0.330519652,0.652862042,-0.32234239
North Dakota,38081,Sargent County,1286,812,2313,474,0.555987895,0.35105923,0.204928664
North Dakota,38083,Sheridan County,688,104,812,584,0.84729064,0.128078818,0.719211823
North Dakota,38085,Sioux County,257,804,1185,-547,0.216877637,0.678481013,-0.461603376
North Dakota,38087,Slope County,379,44,426,335,0.889671362,0.103286385,0.786384977
North Dakota,38089,Stark County,12091,2490,15019,9601,0.805046941,0.165789999,0.639256941
North Dakota,38091,Steele County,649,392,1085,257,0.598156682,0.361290323,0.236866359
North Dakota,38093,Stutsman County,6981,2670,9939,4311,0.702384546,0.268638696,0.43374585
North Dakota,38095,Towner County,828,317,1172,511,0.706484642,0.270477816,0.436006826
North Dakota,38097,Traill County,2519,1491,4131,1028,0.609779714,0.360929557,0.248850157
North Dakota,38099,Walsh County,3309,1329,4762,1980,0.694876102,0.279084418,0.415791684
North Dakota,38101,Ward County,19921,7264,28159,12657,0.707446997,0.257963706,0.449483291
North Dakota,38103,Wells County,1891,442,2372,1449,0.797217538,0.186340641,0.610876897
North Dakota,38105,Williams County,11707,2157,14285,9550,0.819530977,0.15099755,0.668533427
Ohio,39001,Adams County,9660,2130,11905,7530,0.811423772,0.178916422,0.63250735
Ohio,39003,Allen County,32052,13611,46362,18441,0.691342047,0.29358095,0.397761097
Ohio,39005,Ashland County,19002,6448,25883,12554,0.734149828,0.249121045,0.485028783
Ohio,39007,Ashtabula County,26225,16207,43253,10018,0.606316325,0.374702333,0.231613992
Ohio,39009,Athens County,10386,14047,24876,-3661,0.417510854,0.564680817,-0.147169963
Ohio,39011,Auglaize County,20451,4583,25396,15868,0.805284297,0.18046149,0.624822807
Ohio,39013,Belmont County,23092,9007,32534,14085,0.709780537,0.276848835,0.432931702
Ohio,39015,Brown County,16032,4326,20586,11706,0.778781696,0.210142816,0.568638881
Ohio,39017,Butler County,111722,67729,182034,43993,0.613742488,0.372067855,0.241674632
Ohio,39019,Carroll County,10525,3206,13957,7319,0.754101884,0.229705524,0.52439636
Ohio,39021,Champaign County,14086,4946,19369,9140,0.727244566,0.255356497,0.471888069
Ohio,39023,Clark County,38217,23625,62870,14592,0.60787339,0.37577541,0.23209798
Ohio,39025,Clermont County,73077,33505,108531,39572,0.673328358,0.308713639,0.364614718
Ohio,39027,Clinton County,15061,4556,19940,10505,0.755315948,0.228485456,0.526830491
Ohio,39029,Columbiana County,35124,13183,49169,21941,0.714352539,0.268116089,0.44623645
Ohio,39031,Coshocton County,11982,4057,16348,7925,0.732933692,0.248164913,0.484768779
Ohio,39033,Crawford County,15043,4831,20222,10212,0.74389279,0.23889823,0.50499456
Ohio,39035,Cuyahoga County,195089,402315,605268,-207226,0.322318378,0.66468903,-0.342370652
Ohio,39037,Darke County,21569,4668,26621,16901,0.81022501,0.175350287,0.634874723
Ohio,39039,Defiance County,12778,5870,19032,6908,0.671395544,0.308427911,0.362967633
Ohio,39041,Delaware County,65163,56961,124004,8202,0.525491113,0.459348086,0.066143028
Ohio,39043,Erie County,21724,17142,39523,4582,0.549654631,0.433722136,0.115932495
Ohio,39045,Fairfield County,49714,30634,81591,19080,0.609307399,0.375458077,0.233849322
Ohio,39047,Fayette County,9220,2911,12305,6309,0.749288907,0.2365705,0.512718407
Ohio,39049,Franklin County,203154,391584,606022,-188430,0.335225454,0.64615476,-0.310929306
Ohio,39051,Fulton County,15396,6545,22299,8851,0.690434549,0.29351092,0.396923629
Ohio,39053,Gallia County,10289,2911,13358,7378,0.770250037,0.217921845,0.552328193
Ohio,39055,Geauga County,33581,20980,55381,12601,0.606363193,0.378830285,0.227532908
Ohio,39057,Greene County,50937,34023,86616,16914,0.588078415,0.392802715,0.1952757
Ohio,39059,Guernsey County,13077,4498,17806,8579,0.734415366,0.252611479,0.481803886
Ohio,39061,Hamilton County,173015,238101,417574,-65086,0.414333747,0.570200731,-0.155866984
Ohio,39063,Hancock County,25796,11535,37999,14261,0.67885997,0.30356062,0.37529935
Ohio,39065,Hardin County,9698,3025,12954,6673,0.748649066,0.233518604,0.515130462
Ohio,39067,Harrison County,5668,1742,7500,3926,0.755733333,0.232266667,0.523466667
Ohio,39069,Henry County,10273,3995,14482,6278,0.709363348,0.275859688,0.43350366
Ohio,39071,Highland County,15369,3741,19303,11628,0.796197482,0.193804072,0.60239341
Ohio,39073,Hocking County,9554,3836,13786,5718,0.693021906,0.2782533,0.414768606
Ohio,39075,Holmes County,10645,1981,12809,8664,0.831056289,0.154656882,0.676399407
Ohio,39077,Huron County,18537,7643,26628,10894,0.696146913,0.287028692,0.409118221
Ohio,39079,Jackson County,10804,3193,14160,7611,0.76299435,0.22549435,0.5375
Ohio,39081,Jefferson County,22309,9823,32572,12486,0.684913423,0.301578042,0.38333538
Ohio,39083,Knox County,21825,8433,30703,13392,0.710842589,0.274663714,0.436178875
Ohio,39085,Lake County,71615,54337,127867,17278,0.56007414,0.424949361,0.135124778
Ohio,39087,Lawrence County,19759,7353,27427,12406,0.720421482,0.268093485,0.452327998
Ohio,39089,Licking County,57965,32324,91830,25641,0.631220734,0.351998258,0.279222476
Ohio,39091,Logan County,17625,4990,22985,12635,0.766804438,0.217098107,0.54970633
Ohio,39093,Lorain County,76719,72792,151988,3927,0.504770113,0.478932547,0.025837566
Ohio,39095,Lucas County,79628,111989,194882,-32361,0.408595971,0.574650301,-0.16605433
Ohio,39097,Madison County,13445,5558,19309,7887,0.696307421,0.287845046,0.408462375
Ohio,39099,Mahoning County,58601,56346,116565,2255,0.502732381,0.483386951,0.01934543
Ohio,39101,Marion County,18526,8089,27126,10437,0.682960997,0.298200988,0.384760009
Ohio,39103,Medina County,63451,39326,104378,24125,0.6078963,0.376765219,0.231131081
Ohio,39105,Meigs County,8163,2452,10764,5711,0.758361204,0.227796358,0.530564846
Ohio,39107,Mercer County,19145,3981,23426,15164,0.817254333,0.169939384,0.647314949
Ohio,39109,Miami County,40531,15420,56968,25111,0.711469597,0.270678276,0.440791321
Ohio,39111,Monroe County,5392,1597,7066,3795,0.763090858,0.226011888,0.53707897
Ohio,39113,Montgomery County,126085,131592,262560,-5507,0.480214046,0.5011883,-0.020974254
Ohio,39115,Morgan County,4932,1703,6721,3229,0.733819372,0.253384913,0.480434459
Ohio,39117,Morrow County,13784,3988,18088,9796,0.762052189,0.220477665,0.541574525
Ohio,39119,Muskingum County,27334,11755,39693,15579,0.688635276,0.296147935,0.39248734
Ohio,39121,Noble County,5024,1156,6221,3868,0.807587205,0.185822215,0.62176499
Ohio,39123,Ottawa County,14285,8847,23525,5438,0.607226355,0.376068013,0.231158342
Ohio,39125,Paulding County,6927,2172,9280,4755,0.746443966,0.234051724,0.512392241
Ohio,39127,Perry County,11959,4006,16179,7953,0.739168057,0.24760492,0.491563137
Ohio,39129,Pickaway County,20059,7167,27630,12892,0.725986247,0.259391965,0.466594282
Ohio,39131,Pike County,8872,3051,12063,5821,0.735472105,0.252922159,0.482549946
Ohio,39133,Portage County,45034,34935,81280,10099,0.554060039,0.429810531,0.124249508
Ohio,39135,Preble County,16697,4435,21437,12262,0.778886971,0.206885292,0.572001679
Ohio,39137,Putnam County,16218,3152,19671,13066,0.824462407,0.16023588,0.664226526
Ohio,39139,Richland County,40534,17231,58601,23303,0.691694681,0.294039351,0.39765533
Ohio,39141,Ross County,21687,10345,32531,11342,0.66665642,0.318004365,0.348652055
Ohio,39143,Sandusky County,18487,10391,29490,8096,0.626890471,0.352356731,0.27453374
Ohio,39145,Scioto County,21926,8876,31146,13050,0.703974828,0.284980415,0.418994413
Ohio,39147,Seneca County,16739,8147,25322,8592,0.661045731,0.32173604,0.339309691
Ohio,39149,Shelby County,19988,4399,24785,15589,0.806455517,0.177486383,0.628969135
Ohio,39151,Stark County,108610,74336,185714,34274,0.584823977,0.400271385,0.184552592
Ohio,39153,Summit County,122023,148151,274768,-26128,0.444094654,0.539185786,-0.095091131
Ohio,39155,Trumbull County,53756,43534,98677,10222,0.544767271,0.441176769,0.103590502
Ohio,39157,Tuscarawas County,29519,12643,42820,16876,0.689374124,0.295259225,0.3941149
Ohio,39159,Union County,21233,10985,32838,10248,0.646598453,0.334520982,0.312077471
Ohio,39161,Van Wert County,11470,3026,14767,8444,0.776731902,0.204916368,0.571815535
Ohio,39163,Vinton County,4525,1306,5902,3219,0.766689258,0.221280922,0.545408336
Ohio,39165,Warren County,85069,45040,132391,40029,0.642558784,0.340204395,0.30235439
Ohio,39167,Washington County,21798,9114,31382,12684,0.694602001,0.290421261,0.404180741
Ohio,39169,Wayne County,33618,24040,58342,9578,0.576222961,0.412053066,0.164169895
Ohio,39171,Williams County,13218,4726,18290,8492,0.722689995,0.258392564,0.46429743
Ohio,39173,Wood County,34815,29797,65860,5018,0.528621318,0.452429396,0.076191922
Ohio,39175,Wyandot County,8248,2690,11122,5558,0.741593239,0.241862974,0.499730264
Oklahoma,40001,Adair County,5585,1387,7108,4198,0.785734384,0.195132245,0.590602138
Oklahoma,40003,Alfalfa County,1978,232,2262,1746,0.874447392,0.102564103,0.771883289
Oklahoma,40005,Atoka County,4557,765,5389,3792,0.845611431,0.141955836,0.703655595
Oklahoma,40007,Beaver County,1968,190,2178,1778,0.903581267,0.087235996,0.816345271
Oklahoma,40009,Beckham County,6767,1048,7948,5719,0.85140916,0.131857071,0.719552089
Oklahoma,40011,Blaine County,3136,688,3901,2448,0.803896437,0.176365035,0.627531402
Oklahoma,40013,Bryan County,12344,3323,15976,9021,0.772658988,0.207999499,0.564659489
Oklahoma,40015,Caddo County,7013,2670,9859,4343,0.711329749,0.270818541,0.440511208
Oklahoma,40017,Canadian County,43550,16742,61940,26808,0.703099774,0.270293833,0.432805941
Oklahoma,40019,Carter County,14699,4470,19479,10229,0.754607526,0.229477899,0.525129627
Oklahoma,40021,Cherokee County,11223,6027,17714,5196,0.63356667,0.340239359,0.293327312
Oklahoma,40023,Choctaw County,4698,1082,5832,3616,0.805555556,0.185528121,0.620027435
Oklahoma,40025,Cimarron County,970,70,1054,900,0.920303605,0.066413662,0.853889943
Oklahoma,40027,Cleveland County,66677,49827,119778,16850,0.556671509,0.41599459,0.140676919
Oklahoma,40029,Coal County,2091,374,2524,1717,0.82844691,0.148177496,0.680269414
Oklahoma,40031,Comanche County,20905,13747,35631,7158,0.586708204,0.385815722,0.200892481
Oklahoma,40033,Cotton County,2117,393,2572,1724,0.823094868,0.152799378,0.67029549
Oklahoma,40035,Craig County,4686,1217,6032,3469,0.776856764,0.201757294,0.575099469
Oklahoma,40037,Creek County,23294,6577,30505,16717,0.763612523,0.215603999,0.548008523
Oklahoma,40039,Custer County,8060,2369,10691,5691,0.753905154,0.221588252,0.532316902
Oklahoma,40041,Delaware County,13557,3472,17245,10085,0.78614091,0.20133372,0.58480719
Oklahoma,40043,Dewey County,2124,214,2359,1910,0.900381518,0.090716405,0.809665112
Oklahoma,40045,Ellis County,1688,162,1873,1526,0.901227977,0.086492258,0.814735718
Oklahoma,40047,Garfield County,16970,4919,22430,12051,0.756576014,0.219304503,0.537271511
Oklahoma,40049,Garvin County,8878,1865,10922,7013,0.812854789,0.170756272,0.642098517
Oklahoma,40051,Grady County,18538,4144,23101,14394,0.802476083,0.179386174,0.62308991
Oklahoma,40053,Grant County,1916,280,2226,1636,0.860736748,0.125786164,0.734950584
Oklahoma,40055,Greer County,1605,328,1973,1277,0.813482007,0.166244298,0.647237709
Oklahoma,40057,Harmon County,747,177,933,570,0.800643087,0.189710611,0.610932476
Oklahoma,40059,Harper County,1327,136,1487,1191,0.892400807,0.091459314,0.800941493
Oklahoma,40061,Haskell County,4165,783,5014,3382,0.830674112,0.156162744,0.674511368
Oklahoma,40063,Hughes County,3875,919,4857,2956,0.797817583,0.189211447,0.608606135
Oklahoma,40065,Jackson County,6392,1646,8221,4746,0.777520983,0.200218951,0.577302031
Oklahoma,40067,Jefferson County,2026,319,2385,1707,0.849475891,0.133752621,0.71572327
Oklahoma,40069,Johnston County,3441,738,4251,2703,0.809456598,0.17360621,0.635850388
Oklahoma,40071,Kay County,12834,4040,17249,8794,0.744043133,0.234216476,0.509826657
Oklahoma,40073,Kingfisher County,5521,854,6465,4667,0.853982985,0.132095901,0.721887084
Oklahoma,40075,Kiowa County,2673,699,3427,1974,0.779982492,0.203968486,0.576014006
Oklahoma,40077,Latimer County,3437,762,4249,2675,0.808896211,0.179336314,0.629559896
Oklahoma,40079,Le Flore County,15213,3299,18805,11914,0.808986972,0.175432066,0.633554906
Oklahoma,40081,Lincoln County,12013,2609,14888,9404,0.806891456,0.175241805,0.631649651
Oklahoma,40083,Logan County,15608,5455,21574,10153,0.723463428,0.252850654,0.470612775
Oklahoma,40085,Love County,3305,711,4076,2594,0.810843965,0.174435721,0.636408243
Oklahoma,40087,McClain County,15295,3582,19236,11713,0.795123726,0.18621335,0.608910376
Oklahoma,40089,McCurtain County,9485,1858,11467,7627,0.827156187,0.162030174,0.665126014
Oklahoma,40091,McIntosh County,6172,2031,8335,4141,0.740491902,0.243671266,0.496820636
Oklahoma,40093,Major County,3084,320,3467,2764,0.889529853,0.092298817,0.797231035
Oklahoma,40095,Marshall County,4891,1100,6064,3791,0.806563325,0.181398417,0.625164908
Oklahoma,40097,Mayes County,12749,3581,16626,9168,0.766811019,0.215385541,0.551425478
Oklahoma,40099,Murray County,4612,1156,5894,3456,0.782490668,0.196131659,0.586359009
Oklahoma,40101,Muskogee County,16526,8027,25081,8499,0.658905147,0.32004306,0.338862087
Oklahoma,40103,Noble County,3821,1003,4938,2818,0.773795059,0.203118672,0.570676387
Oklahoma,40105,Nowata County,3610,712,4391,2898,0.822136188,0.162149852,0.659986336
Oklahoma,40107,Okfuskee County,3058,896,4038,2162,0.757305597,0.221892026,0.535413571
Oklahoma,40109,Oklahoma County,145050,141724,294740,3326,0.492128656,0.480844134,0.011284522
Oklahoma,40111,Okmulgee County,9668,4357,14313,5311,0.675469853,0.30440858,0.371061273
Oklahoma,40113,Osage County,14121,6002,20538,8119,0.687554777,0.292238777,0.395316
Oklahoma,40115,Ottawa County,8545,2686,11438,5859,0.747071166,0.234831264,0.512239902
Oklahoma,40117,Pawnee County,5267,1363,6786,3904,0.776156793,0.200854701,0.575302093
Oklahoma,40119,Payne County,17813,10904,29643,6909,0.600917586,0.36784401,0.233073576
Oklahoma,40121,Pittsburg County,13851,3768,17924,10083,0.772762776,0.210220933,0.562541843
Oklahoma,40123,Pontotoc County,10805,4117,15320,6688,0.705287206,0.268733681,0.436553525
Oklahoma,40125,Pottawatomie County,20240,7275,28185,12965,0.718112471,0.258116019,0.459996452
Oklahoma,40127,Pushmataha County,4016,668,4739,3348,0.847436168,0.140958008,0.70647816
Oklahoma,40129,Roger Mills County,1629,168,1834,1461,0.888222465,0.091603053,0.796619411
Oklahoma,40131,Rogers County,34031,9589,44553,24442,0.763831841,0.215226809,0.548605032
Oklahoma,40133,Seminole County,6011,2150,8337,3861,0.721002759,0.25788653,0.463116229
Oklahoma,40135,Sequoyah County,12113,3035,15386,9078,0.787274145,0.197257247,0.590016898
Oklahoma,40137,Stephens County,15560,3154,19057,12406,0.816497875,0.16550349,0.650994385
Oklahoma,40139,Texas County,4505,894,5521,3611,0.815975367,0.161927187,0.65404818
Oklahoma,40141,Tillman County,2076,597,2708,1479,0.76661743,0.220457903,0.546159527
Oklahoma,40143,Tulsa County,150574,108996,266678,41578,0.564628503,0.40871763,0.155910874
Oklahoma,40145,Wagoner County,26165,8464,35338,17701,0.740421076,0.239515536,0.500905541
Oklahoma,40147,Washington County,17076,5790,23501,11286,0.726607378,0.246372495,0.480234884
Oklahoma,40149,Washita County,4086,598,4777,3488,0.855348545,0.125183169,0.730165376
Oklahoma,40151,Woods County,2993,591,3678,2402,0.813757477,0.160685155,0.653072322
Oklahoma,40153,Woodward County,6611,1005,7785,5606,0.849197174,0.129094412,0.720102762
Oregon,41001,Baker County,7316,2332,9878,4984,0.740635756,0.236080178,0.504555578
Oregon,41003,Benton County,14647,35438,52134,-20791,0.280949093,0.679748341,-0.398799248
Oregon,41005,Clackamas County,108407,136782,253206,-28375,0.428137564,0.540200469,-0.112062905
Oregon,41007,Clatsop County,10001,12740,23519,-2739,0.425230665,0.541689698,-0.116459033
Oregon,41009,Columbia County,16779,13535,31518,3244,0.53236246,0.429437147,0.102925313
Oregon,41011,Coos County,21488,14024,36484,7464,0.588970508,0.384387677,0.204582831
Oregon,41013,Crook County,11103,3715,15165,7388,0.73214639,0.244971975,0.487174415
Oregon,41015,Curry County,8441,6023,14843,2418,0.568685576,0.405780503,0.162905073
Oregon,41017,Deschutes County,54183,64102,121732,-9919,0.445100713,0.526582986,-0.081482273
Oregon,41019,Douglas County,42513,18780,63107,23733,0.673665362,0.297589808,0.376075554
Oregon,41021,Gilliam County,830,323,1172,507,0.708191126,0.27559727,0.432593857
Oregon,41023,Grant County,3537,923,4577,2614,0.772776928,0.201660476,0.571116452
Oregon,41025,Harney County,3465,890,4465,2575,0.776035834,0.199328108,0.576707727
Oregon,41027,Hood River County,3858,8530,12745,-4672,0.302706944,0.669282071,-0.366575128
Oregon,41029,Jackson County,63012,58386,125184,4626,0.503355061,0.466401457,0.036953604
Oregon,41031,Jefferson County,7044,4306,11666,2738,0.603805932,0.369106806,0.234699126
Oregon,41033,Josephine County,30954,17908,50205,13046,0.616552136,0.35669754,0.259854596
Oregon,41035,Klamath County,25048,10260,36331,14788,0.689438771,0.282403457,0.407035314
Oregon,41037,Lake County,3449,788,4336,2661,0.795433579,0.181734317,0.613699262
Oregon,41039,Lane County,79208,132015,218521,-52807,0.362473172,0.60412958,-0.241656408
Oregon,41041,Lincoln County,12336,17248,30441,-4912,0.405242929,0.566604251,-0.161361322
Oregon,41043,Linn County,42708,25893,71148,16815,0.60026986,0.363931523,0.236338337
Oregon,41045,Malheur County,8101,3202,11653,4899,0.695185789,0.274779027,0.420406762
Oregon,41047,Marion County,77292,78537,161287,-1245,0.479220272,0.486939431,-0.007719159
Oregon,41049,Morrow County,3557,1345,5060,2212,0.702964427,0.265810277,0.43715415
Oregon,41051,Multnomah County,81868,363405,458395,-281537,0.178597061,0.792776972,-0.61417991
Oregon,41053,Polk County,23259,22431,47279,828,0.491952029,0.474438969,0.017513061
Oregon,41055,Sherman County,914,257,1197,657,0.763575606,0.214703425,0.54887218
Oregon,41057,Tillamook County,8306,7956,16725,350,0.496621824,0.475695067,0.020926756
Oregon,41059,Umatilla County,21002,10499,32539,10503,0.645440856,0.322658963,0.322781892
Oregon,41061,Union County,10247,4227,14862,6020,0.689476517,0.284416633,0.405059884
Oregon,41063,Wallowa County,3390,1619,5128,1771,0.661076443,0.315717629,0.345358814
Oregon,41065,Wasco County,6965,6467,13904,498,0.500934983,0.465117952,0.035817031
Oregon,41067,Washington County,98197,206972,316308,-108775,0.310447412,0.654336912,-0.3438895
Oregon,41069,Wheeler County,710,216,963,494,0.737279335,0.224299065,0.51298027
Oregon,41071,Yamhill County,28602,26401,57085,2201,0.501042305,0.462485767,0.038556538
Pennsylvania,42001,Adams County,37009,17919,55814,19090,0.663077364,0.321048482,0.342028882
Pennsylvania,42003,Allegheny County,274028,415737,700530,-141709,0.391172398,0.593460665,-0.202288267
Pennsylvania,42005,Armstrong County,27112,8352,35881,18760,0.755608818,0.232769432,0.522839386
Pennsylvania,42007,Beaver County,53886,37389,92767,16497,0.580874664,0.40304203,0.177832634
Pennsylvania,42009,Bedford County,22529,4266,27018,18263,0.833851506,0.157894737,0.67595677
Pennsylvania,42011,Berks County,105941,89530,198803,16411,0.532894373,0.450345317,0.082549056
Pennsylvania,42013,Blair County,44714,17425,62898,27289,0.710897008,0.277035836,0.433861172
Pennsylvania,42015,Bradford County,21514,7978,30056,13536,0.715797179,0.265437849,0.450359329
Pennsylvania,42017,Bucks County,182742,198251,385933,-15509,0.47350706,0.513692791,-0.040185732
Pennsylvania,42019,Butler County,73023,36534,111017,36489,0.657764126,0.329084735,0.328679391
Pennsylvania,42021,Cambria County,47885,21614,70418,26271,0.680010793,0.306938567,0.373072226
Pennsylvania,42023,Cameron County,1771,634,2440,1137,0.725819672,0.259836066,0.465983607
Pennsylvania,42025,Carbon County,21607,10990,33018,10617,0.65440063,0.332848749,0.321551881
Pennsylvania,42027,Centre County,36042,39718,77100,-3676,0.467470817,0.515149157,-0.04767834
Pennsylvania,42029,Chester County,126844,179065,310650,-52221,0.408318043,0.576420409,-0.168102366
Pennsylvania,42031,Clarion County,14363,4615,19234,9748,0.746750546,0.23993969,0.506810856
Pennsylvania,42033,Clearfield County,28984,9598,39124,19386,0.740824047,0.245322564,0.495501482
Pennsylvania,42035,Clinton County,11668,5406,17321,6262,0.673633162,0.312106691,0.361526471
Pennsylvania,42037,Columbia County,19752,10289,30669,9463,0.644037954,0.335485344,0.30855261
Pennsylvania,42039,Crawford County,27990,12584,41150,15406,0.680194411,0.305808019,0.374386391
Pennsylvania,42041,Cumberland County,76149,61168,139711,14981,0.54504656,0.437818067,0.107228493
Pennsylvania,42043,Dauphin County,65129,77387,144861,-12258,0.44959651,0.534215558,-0.084619049
Pennsylvania,42045,Delaware County,116216,200911,321088,-84695,0.361944389,0.625719429,-0.26377504
Pennsylvania,42047,Elk County,11993,4478,16751,7515,0.715957256,0.267327324,0.448629933
Pennsylvania,42049,Erie County,65972,67471,135657,-1499,0.48631475,0.497364677,-0.011049927
Pennsylvania,42051,Fayette County,39956,19486,59952,20470,0.666466507,0.325026688,0.341439819
Pennsylvania,42053,Forest County,1864,715,2621,1149,0.711178939,0.272796643,0.438382297
Pennsylvania,42055,Franklin County,56628,22040,79904,34588,0.708700441,0.275830997,0.432869443
Pennsylvania,42057,Fulton County,6660,1068,7807,5592,0.853080569,0.136800307,0.716280261
Pennsylvania,42059,Greene County,12436,4882,17494,7554,0.710872299,0.279067109,0.43180519
Pennsylvania,42061,Huntingdon County,17059,5448,22844,11611,0.746760637,0.23848713,0.508273507
Pennsylvania,42063,Indiana County,27832,12475,40835,15357,0.681572181,0.305497735,0.376074446
Pennsylvania,42065,Jefferson County,17928,4498,22799,13430,0.786350279,0.197289355,0.589060924
Pennsylvania,42067,Juniata County,9648,2253,12058,7395,0.800132692,0.186846907,0.613285785
Pennsylvania,42069,Lackawanna County,51501,61124,113975,-9623,0.45186225,0.536293047,-0.084430796
Pennsylvania,42071,Lancaster County,156938,112536,273527,44402,0.573756887,0.411425563,0.162331324
Pennsylvania,42073,Lawrence County,29071,15557,45217,13514,0.64292191,0.344052016,0.298869894
Pennsylvania,42075,Lebanon County,45907,23412,70483,22495,0.651320176,0.332165203,0.319154974
Pennsylvania,42077,Lehigh County,82134,95539,179770,-13405,0.456883796,0.531451299,-0.074567503
Pennsylvania,42079,Luzerne County,84649,62983,149103,21666,0.567721642,0.422412695,0.145308948
Pennsylvania,42081,Lycoming County,40885,16722,58473,24163,0.699211602,0.285978144,0.413233458
Pennsylvania,42083,McKean County,13892,5024,19195,8868,0.723730138,0.261734827,0.461995311
Pennsylvania,42085,Mercer County,35282,20426,56420,14856,0.625345622,0.362034739,0.263310883
Pennsylvania,42087,Mifflin County,16532,4560,21317,11972,0.775531266,0.213913778,0.561617488
Pennsylvania,42089,Monroe County,37297,42102,80477,-4805,0.463449184,0.523155684,-0.0597065
Pennsylvania,42091,Montgomery County,182907,313543,501561,-130636,0.364675483,0.625134331,-0.260458847
Pennsylvania,42093,Montour County,5842,3768,9812,2074,0.595393396,0.384019568,0.211373828
Pennsylvania,42095,Northampton County,82830,84145,169403,-1315,0.48895238,0.496714934,-0.007762554
Pennsylvania,42097,Northumberland County,28412,12414,41560,15998,0.683638114,0.298700674,0.38493744
Pennsylvania,42099,Perry County,17879,5704,24032,12175,0.743966378,0.2373502,0.506616178
Pennsylvania,42101,Philadelphia County,126253,558264,690933,-432011,0.182728282,0.807985724,-0.625257442
Pennsylvania,42103,Pike County,18979,12878,32179,6101,0.589794587,0.400198887,0.189595699
Pennsylvania,42105,Potter County,7117,1686,8901,5431,0.799573082,0.189416919,0.610156162
Pennsylvania,42107,Schuylkill County,48100,20425,69649,27675,0.690605752,0.293256185,0.397349567
Pennsylvania,42109,Snyder County,13816,4848,18945,8968,0.729268936,0.255898654,0.473370282
Pennsylvania,42111,Somerset County,31105,8543,40093,22562,0.775821216,0.21307959,0.562741626
Pennsylvania,42113,Sullivan County,2622,921,3602,1701,0.727928928,0.255691283,0.472237646
Pennsylvania,42115,Susquehanna County,14879,6084,21325,8795,0.697725674,0.285298945,0.412426729
Pennsylvania,42117,Tioga County,15735,4953,21099,10782,0.745769942,0.234750462,0.51101948
Pennsylvania,42119,Union County,12342,7377,20078,4965,0.61470266,0.367417073,0.247285586
Pennsylvania,42121,Venango County,18286,7475,26198,10811,0.697992213,0.285327124,0.412665089
Pennsylvania,42123,Warren County,14020,5987,20401,8033,0.687221215,0.293466007,0.393755208
Pennsylvania,42125,Washington County,71375,44712,117658,26663,0.606631083,0.380016658,0.226614425
Pennsylvania,42127,Wayne County,18466,9135,27915,9331,0.66150815,0.327243418,0.334264732
Pennsylvania,42129,Westmoreland County,128304,70738,201805,57566,0.635782067,0.350526498,0.285255568
Pennsylvania,42131,Wyoming County,9819,4642,14716,5177,0.667232944,0.315438978,0.351793966
Pennsylvania,42133,York County,143260,85323,232733,57937,0.615555164,0.366613244,0.248941921
Rhode Island,44001,Bristol County,9586,17701,27743,-8115,0.345528602,0.63803482,-0.292506218
Rhode Island,44003,Kent County,41561,48474,91475,-6913,0.454342717,0.529915277,-0.075572561
Rhode Island,44005,Newport County,15532,28878,45091,-13346,0.344458983,0.640438225,-0.295979242
Rhode Island,44007,Providence County,101219,161674,266580,-60455,0.379694651,0.606474604,-0.226779953
Rhode Island,44009,Washington County,29523,43598,74325,-14075,0.397214934,0.58658594,-0.189371006
South Carolina,45001,Abbeville County,9343,5106,14552,4237,0.642042331,0.350879604,0.291162727
South Carolina,45003,Aiken County,51589,32275,85185,19314,0.605611317,0.378881258,0.226730058
South Carolina,45005,Allendale County,835,2718,3593,-1883,0.232396326,0.756470916,-0.524074589
South Carolina,45007,Anderson County,67565,27169,96093,40396,0.703120935,0.282736516,0.420384419
South Carolina,45009,Bamberg County,2417,4010,6482,-1593,0.372878741,0.618636223,-0.245757482
South Carolina,45011,Barnwell County,5492,4720,10321,772,0.532118981,0.457320027,0.074798954
South Carolina,45013,Beaufort County,53194,43419,97835,9775,0.543711351,0.443798232,0.099913119
South Carolina,45015,Berkeley County,57397,45223,104458,12174,0.54947443,0.432929981,0.116544448
South Carolina,45017,Calhoun County,4305,3905,8291,400,0.519237728,0.470992643,0.048245085
South Carolina,45019,Charleston County,93297,121485,218857,-28188,0.426292054,0.555088482,-0.128796429
South Carolina,45021,Cherokee County,18043,6983,25270,11060,0.714008706,0.276335576,0.43767313
South Carolina,45023,Chester County,8660,6941,15757,1719,0.549597005,0.440502634,0.109094371
South Carolina,45025,Chesterfield County,11297,7431,18876,3866,0.598484848,0.393674507,0.204810341
South Carolina,45027,Clarendon County,8361,8250,16733,111,0.499671308,0.49303771,0.006633598
South Carolina,45029,Colleton County,10440,8602,19283,1838,0.541409532,0.446092413,0.095317119
South Carolina,45031,Darlington County,16832,15220,32417,1612,0.519233735,0.46950674,0.049726995
South Carolina,45033,Dillon County,6582,6436,13101,146,0.502404397,0.491260209,0.011144187
South Carolina,45035,Dorchester County,41913,33824,77278,8089,0.542366521,0.437692487,0.104674034
South Carolina,45037,Edgefield County,8184,4953,13304,3231,0.615153337,0.372294047,0.24285929
South Carolina,45039,Fairfield County,4625,7382,12136,-2757,0.381097561,0.608272907,-0.227175346
South Carolina,45041,Florence County,32605,31149,64495,1456,0.505543065,0.482967672,0.022575393
South Carolina,45043,Georgetown County,20487,15822,36668,4665,0.558716047,0.4314934,0.127222646
South Carolina,45045,Greenville County,150021,103030,258155,46991,0.581127617,0.399101315,0.182026302
South Carolina,45047,Greenwood County,19431,12145,32006,7286,0.607104918,0.379460101,0.227644817
South Carolina,45049,Hampton County,3905,5322,9303,-1417,0.419757068,0.572073525,-0.152316457
South Carolina,45051,Horry County,118821,59180,179744,59641,0.661056836,0.329246039,0.331810798
South Carolina,45053,Jasper County,7065,7162,14889,-97,0.474511384,0.481026261,-0.006514877
South Carolina,45055,Kershaw County,20471,12699,33629,7772,0.60873056,0.377620506,0.231110054
South Carolina,45057,Lancaster County,30312,18937,49868,11375,0.60784471,0.37974252,0.22810219
South Carolina,45059,Laurens County,20004,10159,30488,9845,0.656127001,0.333213067,0.322913933
South Carolina,45061,Lee County,3008,5329,8431,-2321,0.356778555,0.632072115,-0.275293559
South Carolina,45063,Lexington County,92817,49301,144568,43516,0.642030048,0.34102291,0.301007139
South Carolina,45065,McCormick County,2958,2687,5697,271,0.519220642,0.471651747,0.047568896
South Carolina,45067,Marion County,5711,8872,14704,-3161,0.388397715,0.603373232,-0.214975517
South Carolina,45069,Marlboro County,5044,6290,11446,-1246,0.440677966,0.549536956,-0.10885899
South Carolina,45071,Newberry County,11443,6958,18631,4485,0.614191401,0.373463582,0.240727819
South Carolina,45073,Oconee County,29698,10414,40668,19284,0.730254746,0.256073571,0.474181174
South Carolina,45075,Orangeburg County,13603,27295,41205,-13692,0.330129839,0.662419609,-0.332289771
South Carolina,45077,Pickens County,42907,13645,57546,29262,0.745612206,0.237114656,0.50849755
South Carolina,45079,Richland County,58313,132570,193822,-74257,0.30085852,0.683978083,-0.383119563
South Carolina,45081,Saluda County,6210,2963,9274,3247,0.669613975,0.319495363,0.350118611
South Carolina,45083,Spartanburg County,93560,52926,148655,40634,0.629376745,0.356032424,0.273344321
South Carolina,45085,Sumter County,21000,27379,48920,-6379,0.429272281,0.559668847,-0.130396566
South Carolina,45087,Union County,8183,4935,13257,3248,0.617258807,0.372256167,0.24500264
South Carolina,45089,Williamsburg County,5532,10289,15985,-4757,0.346074445,0.643665937,-0.297591492
South Carolina,45091,York County,82727,59008,144050,23719,0.574293648,0.409635543,0.164658105
South Dakota,46003,Aurora County,1052,317,1405,735,0.748754448,0.225622776,0.523131673
South Dakota,46005,Beadle County,4808,2107,7081,2701,0.679000141,0.297556842,0.381443299
South Dakota,46007,Bennett County,694,466,1183,228,0.586644125,0.393913779,0.192730347
South Dakota,46009,Bon Homme County,2235,721,3001,1514,0.744751749,0.240253249,0.5044985
South Dakota,46011,Brookings County,8000,6110,14567,1890,0.549186517,0.419441203,0.129745315
South Dakota,46013,Brown County,10580,6538,17547,4042,0.602952072,0.372599305,0.230352767
South Dakota,46015,Brule County,1750,673,2490,1077,0.702811245,0.270281124,0.43253012
South Dakota,46017,Buffalo County,183,352,549,-169,0.333333333,0.641165756,-0.307832423
South Dakota,46019,Butte County,3731,939,4802,2792,0.77696793,0.195543524,0.581424406
South Dakota,46021,Campbell County,747,117,873,630,0.855670103,0.134020619,0.721649485
South Dakota,46023,Charles Mix County,2552,1177,3783,1375,0.674596881,0.311128734,0.363468147
South Dakota,46025,Clark County,1373,437,1850,936,0.742162162,0.236216216,0.505945946
South Dakota,46027,Clay County,2456,3083,5698,-627,0.431028431,0.541067041,-0.11003861
South Dakota,46029,Codington County,8958,3837,13161,5121,0.680647367,0.291543196,0.389104171
South Dakota,46031,Corson County,647,622,1283,25,0.504286828,0.484801247,0.019485581
South Dakota,46033,Custer County,3852,1522,5494,2330,0.701128504,0.277029487,0.424099017
South Dakota,46035,Davison County,5613,2648,8454,2965,0.663946061,0.313224509,0.350721552
South Dakota,46037,Day County,1869,1052,2964,817,0.630566802,0.354925776,0.275641026
South Dakota,46039,Deuel County,1699,609,2350,1090,0.722978723,0.259148936,0.463829787
South Dakota,46041,Dewey County,790,1131,1966,-341,0.401831129,0.575279756,-0.173448627
South Dakota,46043,Douglas County,1468,216,1707,1252,0.859988284,0.126537786,0.733450498
South Dakota,46045,Edmunds County,1538,417,1985,1121,0.774811083,0.210075567,0.564735516
South Dakota,46047,Fall River County,2878,1053,4042,1825,0.712023751,0.260514597,0.451509154
South Dakota,46049,Faulk County,964,198,1182,766,0.815566836,0.16751269,0.648054146
South Dakota,46051,Grant County,2618,1056,3745,1562,0.699065421,0.281975968,0.417089453
South Dakota,46053,Gregory County,1772,455,2259,1317,0.784417884,0.201416556,0.583001328
South Dakota,46055,Haakon County,1026,105,1137,921,0.90237467,0.092348285,0.810026385
South Dakota,46057,Hamlin County,2372,647,3083,1725,0.769380474,0.209860525,0.559519948
South Dakota,46059,Hand County,1433,373,1836,1060,0.780501089,0.203159041,0.577342048
South Dakota,46061,Hanson County,1793,557,2388,1236,0.750837521,0.233249581,0.51758794
South Dakota,46063,Harding County,748,49,813,699,0.9200492,0.060270603,0.859778598
South Dakota,46065,Hughes County,5522,2953,8723,2569,0.633039092,0.338530322,0.29450877
South Dakota,46067,Hutchinson County,2944,762,3767,2182,0.781523759,0.202282984,0.579240775
South Dakota,46069,Hyde County,564,136,710,428,0.794366197,0.191549296,0.602816901
South Dakota,46071,Jackson County,738,359,1115,379,0.661883408,0.321973094,0.339910314
South Dakota,46073,Jerauld County,721,270,1006,451,0.716699801,0.268389662,0.448310139
South Dakota,46075,Jones County,498,90,599,408,0.831385643,0.150250417,0.681135225
South Dakota,46077,Kingsbury County,1904,819,2779,1085,0.685138539,0.294710327,0.390428212
South Dakota,46079,Lake County,3681,2068,5873,1613,0.626766559,0.352119871,0.274646688
South Dakota,46081,Lawrence County,8753,4537,13828,4216,0.632991033,0.328102401,0.304888632
South Dakota,46083,Lincoln County,19676,11981,32455,7695,0.606254814,0.369157295,0.23709752
South Dakota,46085,Lyman County,1042,525,1597,517,0.652473388,0.32874139,0.323731997
South Dakota,46087,McCook County,2068,769,2900,1299,0.713103448,0.265172414,0.447931034
South Dakota,46089,McPherson County,1075,222,1324,853,0.811933535,0.167673716,0.644259819
South Dakota,46091,Marshall County,1287,858,2178,429,0.590909091,0.393939394,0.196969697
South Dakota,46093,Meade County,9875,3285,13670,6590,0.722384784,0.240307242,0.482077542
South Dakota,46095,Mellette County,449,298,769,151,0.583875163,0.387516255,0.196358908
South Dakota,46097,Miner County,787,320,1138,467,0.691564148,0.281195079,0.410369069
South Dakota,46099,Minnehaha County,49249,40482,92326,8767,0.533425037,0.438468037,0.094957
South Dakota,46101,Moody County,1951,1179,3206,772,0.608546475,0.367747973,0.240798503
South Dakota,46102,Oglala Lakota County,297,2829,3200,-2532,0.0928125,0.8840625,-0.79125
South Dakota,46103,Pennington County,35063,20606,57518,14457,0.609600473,0.358253069,0.251347404
South Dakota,46105,Perkins County,1401,239,1669,1162,0.839424805,0.143199521,0.696225285
South Dakota,46107,Potter County,1139,227,1380,912,0.825362319,0.164492754,0.660869565
South Dakota,46109,Roberts County,2404,1828,4307,576,0.558161133,0.424425354,0.133735779
South Dakota,46111,Sanborn County,905,257,1185,648,0.76371308,0.216877637,0.546835443
South Dakota,46115,Spink County,2104,998,3163,1106,0.665191274,0.315523237,0.349668037
South Dakota,46117,Stanley County,1203,421,1652,782,0.728208232,0.254842615,0.473365617
South Dakota,46119,Sully County,726,185,930,541,0.780645161,0.198924731,0.58172043
South Dakota,46121,Todd County,532,1963,2539,-1431,0.209531312,0.773139031,-0.56360772
South Dakota,46123,Tripp County,2161,495,2696,1666,0.801557864,0.183605341,0.617952522
South Dakota,46125,Turner County,3290,1139,4548,2151,0.723394899,0.250439754,0.472955145
South Dakota,46127,Union County,5949,2729,8864,3220,0.671141697,0.307874549,0.363267148
South Dakota,46129,Walworth County,1966,565,2580,1401,0.762015504,0.218992248,0.543023256
South Dakota,46135,Yankton County,6581,4016,10900,2565,0.603761468,0.368440367,0.235321101
South Dakota,46137,Ziebach County,404,481,906,-77,0.445916115,0.530905077,-0.084988962
Tennessee,47001,Anderson County,23163,11733,35527,11430,0.651982999,0.330255862,0.321727137
Tennessee,47003,Bedford County,14317,4443,19039,9874,0.751982772,0.233363097,0.518619675
Tennessee,47005,Benton County,5661,1526,7250,4135,0.780827586,0.210482759,0.570344828
Tennessee,47007,Bledsoe County,4725,971,5758,3754,0.82059743,0.168634943,0.651962487
Tennessee,47009,Blount County,47195,17834,66306,29361,0.711775707,0.268965101,0.442810605
Tennessee,47011,Bradley County,35194,9849,45968,25345,0.765619561,0.214257745,0.551361817
Tennessee,47013,Campbell County,12330,2438,14929,9892,0.825909304,0.163306317,0.662602987
Tennessee,47015,Cannon County,5190,1261,6562,3929,0.790917403,0.192167022,0.598750381
Tennessee,47017,Carroll County,9194,2558,11893,6636,0.773059783,0.215084503,0.55797528
Tennessee,47019,Carter County,19873,4613,24868,15260,0.799139456,0.185499437,0.613640019
Tennessee,47021,Cheatham County,14328,5457,20091,8871,0.713155144,0.271614156,0.441540989
Tennessee,47023,Chester County,5951,1411,7578,4540,0.785299551,0.186196886,0.599102666
Tennessee,47025,Claiborne County,10598,2201,12935,8397,0.819327406,0.170158485,0.649168922
Tennessee,47027,Clay County,2733,735,3506,1998,0.779520821,0.209640616,0.569880205
Tennessee,47029,Cocke County,12182,2524,14870,9658,0.819233356,0.169737727,0.649495629
Tennessee,47031,Coffee County,17863,5704,24313,12159,0.734709826,0.234607,0.500102826
Tennessee,47033,Crockett County,4673,1382,6114,3291,0.764311416,0.2260386,0.538272816
Tennessee,47035,Cumberland County,25167,6728,32307,18439,0.778995264,0.208252082,0.570743183
Tennessee,47037,Davidson County,99415,197846,308325,-98431,0.322435742,0.641680045,-0.319244304
Tennessee,47039,Decatur County,4229,904,5250,3325,0.80552381,0.172190476,0.633333333
Tennessee,47041,DeKalb County,6663,1747,8501,4916,0.783790142,0.205505235,0.578284908
Tennessee,47043,Dickson County,17619,6098,24342,11521,0.723810698,0.250513516,0.473297182
Tennessee,47045,Dyer County,11766,3157,15074,8609,0.78054929,0.209433462,0.571115829
Tennessee,47047,Fayette County,15661,7000,22928,8661,0.683051291,0.305303559,0.377747732
Tennessee,47049,Fentress County,7403,1210,8687,6193,0.852192932,0.139288592,0.71290434
Tennessee,47051,Franklin County,13977,4863,19146,9114,0.730021937,0.253995613,0.476026324
Tennessee,47053,Gibson County,16245,5764,22336,10481,0.727301218,0.258058739,0.469242479
Tennessee,47055,Giles County,9783,3298,13202,6485,0.741024087,0.249810635,0.491213453
Tennessee,47057,Grainger County,8559,1463,10123,7096,0.845500346,0.144522375,0.700977971
Tennessee,47059,Greene County,22185,5183,28057,17002,0.790711765,0.184731083,0.605980682
Tennessee,47061,Grundy County,4795,985,5844,3810,0.820499658,0.168548939,0.651950719
Tennessee,47063,Hamblen County,18789,5497,24625,13292,0.763005076,0.223228426,0.53977665
Tennessee,47065,Hamilton County,91991,75360,170735,16631,0.538794038,0.441385773,0.097408264
Tennessee,47067,Hancock County,2372,362,2744,2010,0.864431487,0.131924198,0.732507289
Tennessee,47069,Hardeman County,5760,4180,10058,1580,0.572678465,0.41558958,0.157088884
Tennessee,47071,Hardin County,9556,1774,11534,7782,0.828507023,0.153806138,0.674700884
Tennessee,47073,Hawkins County,20372,4069,24776,16303,0.822247336,0.164231514,0.658015822
Tennessee,47075,Haywood County,3338,4000,7420,-662,0.449865229,0.539083558,-0.089218329
Tennessee,47077,Henderson County,9797,2092,12020,7705,0.815058236,0.174043261,0.641014975
Tennessee,47079,Henry County,11230,3547,15034,7683,0.746973527,0.235931888,0.511041639
Tennessee,47081,Hickman County,7577,2130,9832,5447,0.770646867,0.216639544,0.554007323
Tennessee,47083,Houston County,2715,869,3681,1846,0.737571312,0.236077153,0.501494159
Tennessee,47085,Humphreys County,6116,2017,8232,4099,0.742954325,0.245019436,0.497934888
Tennessee,47087,Jackson County,4106,1133,5308,2973,0.773549359,0.213451394,0.560097965
Tennessee,47089,Jefferson County,18609,4645,23562,13964,0.789788643,0.197139462,0.592649181
Tennessee,47091,Johnson County,6466,1242,7793,5224,0.829718979,0.159373797,0.670345182
Tennessee,47093,Knox County,124339,91097,219869,33242,0.565514011,0.414323984,0.151190027
Tennessee,47095,Lake County,1492,526,2034,966,0.73352999,0.258603736,0.474926254
Tennessee,47097,Lauderdale County,5672,3193,8963,2479,0.632823831,0.35624233,0.276581502
Tennessee,47099,Lawrence County,15334,3195,18718,12139,0.819211454,0.170691313,0.648520141
Tennessee,47101,Lewis County,4473,1068,5604,3405,0.798179872,0.190578158,0.607601713
Tennessee,47103,Lincoln County,12258,2909,15575,9349,0.787030498,0.186773676,0.600256822
Tennessee,47105,Loudon County,21684,6933,29375,14751,0.738178723,0.236017021,0.502161702
Tennessee,47107,McMinn County,18175,4357,22815,13818,0.796625027,0.190970853,0.605654175
Tennessee,47109,McNairy County,9085,1943,11267,7142,0.806337091,0.172450519,0.633886571
Tennessee,47111,Macon County,8095,1307,9486,6788,0.853362851,0.137781995,0.715580856
Tennessee,47113,Madison County,23922,18309,42847,5613,0.558312134,0.42731113,0.131001004
Tennessee,47115,Marion County,9873,3165,13204,6708,0.747727961,0.239700091,0.50802787
Tennessee,47117,Marshall County,11029,3603,14862,7426,0.742093931,0.242430359,0.499663572
Tennessee,47119,Maury County,31408,14386,46670,17022,0.672980501,0.308249411,0.364731091
Tennessee,47121,Meigs County,4464,1008,5529,3456,0.807379273,0.182311449,0.625067824
Tennessee,47123,Monroe County,16742,3760,20749,12982,0.806882259,0.181213552,0.625668707
Tennessee,47125,Montgomery County,42156,32426,76678,9730,0.549779598,0.422885313,0.126894285
Tennessee,47127,Moore County,2888,573,3539,2315,0.816049732,0.161910144,0.654139587
Tennessee,47129,Morgan County,6926,1161,8218,5765,0.842784132,0.141275249,0.701508883
Tennessee,47131,Obion County,10790,2589,13521,8201,0.798017898,0.19147992,0.606537978
Tennessee,47133,Overton County,7911,2028,10025,5883,0.789127182,0.202294264,0.586832918
Tennessee,47135,Perry County,2775,615,3428,2160,0.809509918,0.179404901,0.630105018
Tennessee,47137,Pickett County,2373,524,2922,1849,0.81211499,0.179329227,0.632785763
Tennessee,47139,Polk County,6792,1492,8360,5300,0.812440191,0.1784689,0.633971292
Tennessee,47141,Putnam County,23694,9154,33481,14540,0.707684956,0.273408799,0.434276157
Tennessee,47143,Rhea County,11031,2363,13608,8668,0.810626102,0.173647854,0.636978248
Tennessee,47145,Roane County,19195,6034,25914,13161,0.740719302,0.23284711,0.507872193
Tennessee,47147,Robertson County,24535,8690,33712,15845,0.727782392,0.257771713,0.470010679
Tennessee,47149,Rutherford County,81344,59177,143888,22167,0.565328589,0.411271267,0.154057322
Tennessee,47151,Scott County,8004,986,9052,7018,0.884224481,0.108926204,0.775298277
Tennessee,47153,Sequatchie County,5846,1295,7239,4551,0.807570106,0.178892112,0.628677994
Tennessee,47155,Sevier County,33742,8695,43574,25047,0.774360857,0.199545601,0.574815257
Tennessee,47157,Shelby County,129543,245208,381858,-115665,0.339243907,0.642144462,-0.302900555
Tennessee,47159,Smith County,7124,1798,9035,5326,0.788489209,0.199003874,0.589485335
Tennessee,47161,Stewart County,4942,1230,6283,3712,0.786566927,0.195766354,0.590800573
Tennessee,47163,Sullivan County,55774,17226,74206,38548,0.751610382,0.232137563,0.519472819
Tennessee,47165,Sumner County,63404,27630,92529,35774,0.685233819,0.298609085,0.386624734
Tennessee,47167,Tipton County,20063,6832,27291,13231,0.735150782,0.25033894,0.484811843
Tennessee,47169,Trousdale County,2930,1011,3991,1919,0.734151842,0.25331997,0.480831872
Tennessee,47171,Unicoi County,6593,1610,8294,4983,0.794911985,0.194116229,0.600795756
Tennessee,47173,Union County,6777,1248,8096,5529,0.83708004,0.154150198,0.682929842
Tennessee,47175,Van Buren County,2338,544,2917,1794,0.801508399,0.186492972,0.615015427
Tennessee,47177,Warren County,12323,4126,16692,8197,0.738257848,0.24718428,0.491073568
Tennessee,47179,Washington County,40120,18214,59474,21906,0.674580489,0.306251471,0.368329018
Tennessee,47181,Wayne County,5795,820,6667,4975,0.86920654,0.12299385,0.746212689
Tennessee,47183,Weakley County,10382,3011,13710,7371,0.757257476,0.219620715,0.537636761
Tennessee,47185,White County,9587,2134,11867,7453,0.807870565,0.179826409,0.628044156
Tennessee,47187,Williamson County,86469,50161,139640,36308,0.619228015,0.359216557,0.260011458
Tennessee,47189,Wilson County,50149,22197,74096,27952,0.676811164,0.299570827,0.377240337
Texas,48001,Anderson County,15062,3934,19155,11128,0.786322109,0.205377186,0.580944923
Texas,48003,Andrews County,4937,849,5856,4088,0.84306694,0.144979508,0.698087432
Texas,48005,Angelina County,25070,9136,34628,15934,0.723980594,0.263832737,0.460147857
Texas,48007,Aransas County,9210,2896,12241,6314,0.752389511,0.236581979,0.515807532
Texas,48009,Archer County,4300,446,4796,3854,0.896580484,0.092994162,0.803586322
Texas,48011,Armstrong County,1035,75,1112,960,0.930755396,0.067446043,0.863309353
Texas,48013,Atascosa County,12020,5865,18085,6155,0.664639204,0.324301908,0.340337296
Texas,48015,Austin County,11282,2931,14368,8351,0.785217149,0.203994989,0.58122216
Texas,48017,Bailey County,1430,407,1854,1023,0.771305286,0.219525351,0.551779935
Texas,48019,Bandera County,10050,2503,12703,7547,0.791151696,0.197040069,0.594111627
Texas,48021,Bastrop County,20486,15452,36709,5034,0.55806478,0.420932196,0.137132583
Texas,48023,Baylor County,1478,179,1680,1299,0.879761905,0.106547619,0.773214286
Texas,48025,Bee County,5999,3280,9405,2719,0.637852206,0.348750665,0.289101542
Texas,48027,Bell County,67113,56032,125867,11081,0.533205685,0.445168313,0.088037373
Texas,48029,Bexar County,303871,440823,757667,-136952,0.401061416,0.581816286,-0.18075487
Texas,48031,Blanco County,5429,1905,7419,3524,0.73176978,0.25677315,0.47499663
Texas,48033,Borden County,395,16,412,379,0.958737864,0.038834951,0.919902913
Texas,48035,Bosque County,7446,1552,9094,5894,0.818781614,0.170661975,0.648119639
Texas,48037,Bowie County,27053,10692,38194,16361,0.708304969,0.279939257,0.428365712
Texas,48039,Brazoria County,89939,61780,154037,28159,0.583879198,0.40107247,0.182806728
Texas,48041,Brazos County,47456,35242,84753,12214,0.559932982,0.415820089,0.144112893
Texas,48043,Brewster County,2451,2251,4805,200,0.510093652,0.468470343,0.041623309
Texas,48045,Briscoe County,639,77,724,562,0.882596685,0.106353591,0.776243094
Texas,48047,Brooks County,998,1470,2484,-472,0.401771337,0.59178744,-0.190016103
Texas,48049,Brown County,13681,2103,15940,11578,0.858281054,0.131932246,0.726348808
Texas,48051,Burleson County,6740,1786,8604,4954,0.783356578,0.207577871,0.575778708
Texas,48053,Burnet County,18721,5615,24646,13106,0.759595878,0.227826016,0.531769861
Texas,48055,Caldwell County,7975,6536,14775,1439,0.539763113,0.442368866,0.097394247
Texas,48057,Calhoun County,5640,2146,7853,3494,0.718196867,0.273271361,0.444925506
Texas,48059,Callahan County,6006,734,6826,5272,0.879871081,0.107530032,0.772341049
Texas,48061,Cameron County,48834,63732,113789,-14898,0.429162749,0.560089288,-0.130926539
Texas,48063,Camp County,3626,1392,5057,2234,0.717025905,0.275262013,0.441763892
Texas,48065,Carson County,2747,289,3081,2458,0.891593638,0.093800714,0.797792924
Texas,48067,Cass County,10979,2777,13856,8202,0.792364319,0.200418591,0.591945727
Texas,48069,Castro County,1601,466,2082,1135,0.768972142,0.223823247,0.545148895
Texas,48071,Chambers County,17343,3997,21641,13346,0.801395499,0.184695716,0.616699783
Texas,48073,Cherokee County,15065,4196,19457,10869,0.77427147,0.215655034,0.558616436
Texas,48075,Childress County,1928,305,2259,1623,0.853474989,0.135015494,0.718459495
Texas,48077,Clay County,5064,614,5736,4450,0.882845188,0.107043236,0.775801953
Texas,48079,Cochran County,806,176,996,630,0.809236948,0.176706827,0.63253012
Texas,48081,Coke County,1565,215,1794,1350,0.872352285,0.119843924,0.752508361
Texas,48083,Coleman County,3640,451,4128,3189,0.881782946,0.109253876,0.77252907
Texas,48085,Collin County,250194,227868,486917,22326,0.513832953,0.467981196,0.045851757
Texas,48087,Collingsworth County,1048,155,1218,893,0.860426929,0.1272578,0.73316913
Texas,48089,Colorado County,7440,2403,9912,5037,0.750605327,0.242433414,0.508171913
Texas,48091,Comal County,62260,24369,87942,37891,0.707966614,0.277103091,0.430863524
Texas,48093,Comanche County,5177,852,6084,4325,0.850920447,0.140039448,0.710880999
Texas,48095,Concho County,1058,197,1268,861,0.834384858,0.155362776,0.679022082
Texas,48097,Cooke County,15579,3205,18997,12374,0.820076854,0.168710849,0.651366005
Texas,48099,Coryell County,15397,7542,23425,7855,0.657289221,0.321963714,0.335325507
Texas,48101,Cottle County,543,113,665,430,0.816541353,0.169924812,0.646616541
Texas,48103,Crane County,1247,241,1503,1006,0.829673985,0.160345975,0.669328011
Texas,48105,Crockett County,1219,344,1573,875,0.77495232,0.218690401,0.55626192
Texas,48107,Crosby County,1396,527,1953,869,0.714797747,0.26984127,0.444956477
Texas,48109,Culberson County,415,438,864,-23,0.480324074,0.506944444,-0.02662037
Texas,48111,Dallam County,1386,196,1605,1190,0.863551402,0.12211838,0.741433022
Texas,48113,Dallas County,306572,597407,919929,-290835,0.333256153,0.649405552,-0.316149398
Texas,48115,Dawson County,2951,808,3789,2143,0.778833465,0.213248878,0.565584587
Texas,48117,Deaf Smith County,3293,1263,4608,2030,0.714626736,0.274088542,0.440538194
Texas,48119,Delta County,2157,403,2587,1754,0.833784306,0.155778894,0.678005412
Texas,48121,Denton County,221829,188023,416610,33806,0.532462015,0.451316579,0.081145436
Texas,48123,DeWitt County,6567,1494,8118,5073,0.808943089,0.184035477,0.624907613
Texas,48125,Dickens County,850,130,985,720,0.862944162,0.131979695,0.730964467
Texas,48127,Dimmit County,1384,2264,3666,-880,0.377523186,0.61756683,-0.240043644
Texas,48129,Donley County,1438,198,1648,1240,0.872572816,0.120145631,0.752427184
Texas,48131,Duval County,2442,2573,5050,-131,0.483564356,0.50950495,-0.025940594
Texas,48133,Eastland County,7216,982,8271,6234,0.872445895,0.118728086,0.753717809
Texas,48135,Ector County,32586,11310,44417,21276,0.733638021,0.254632235,0.479005786
Texas,48137,Edwards County,893,166,1064,727,0.839285714,0.156015038,0.683270677
Texas,48139,Ellis County,56651,27513,85566,29138,0.662073721,0.321541266,0.340532454
Texas,48141,El Paso County,81235,168801,254576,-87566,0.319099208,0.663067218,-0.34396801
Texas,48143,Erath County,13669,2914,16837,10755,0.811842965,0.173071212,0.638771753
Texas,48145,Falls County,4177,1899,6133,2278,0.681069623,0.309636393,0.37143323
Texas,48147,Fannin County,12150,2638,14969,9512,0.811677467,0.176230877,0.63544659
Texas,48149,Fayette County,10163,2650,12924,7513,0.78636645,0.205044878,0.581321572
Texas,48151,Fisher County,1448,352,1826,1096,0.792990142,0.192771084,0.600219058
Texas,48153,Floyd County,1581,437,2035,1144,0.776904177,0.214742015,0.562162162
Texas,48155,Foard County,445,99,551,346,0.807622505,0.179673321,0.627949183
Texas,48157,Fort Bend County,157595,195191,357833,-37596,0.440414942,0.545480713,-0.105065771
Texas,48159,Franklin County,4153,803,5000,3350,0.8306,0.1606,0.67
Texas,48161,Freestone County,6966,1629,8678,5337,0.802719521,0.187716064,0.615003457
Texas,48163,Frio County,2812,2421,5264,391,0.534194529,0.459916413,0.074278116
Texas,48165,Gaines County,5323,572,5960,4751,0.893120805,0.095973154,0.797147651
Texas,48167,Galveston County,93306,58247,153843,35059,0.606501433,0.378613262,0.227888172
Texas,48169,Garza County,1411,231,1651,1180,0.854633555,0.139915203,0.714718353
Texas,48171,Gillespie County,12495,3163,15817,9332,0.789972814,0.199974711,0.589998103
Texas,48173,Glasscock County,611,39,653,572,0.93568147,0.059724349,0.875957121
Texas,48175,Goliad County,3081,872,3978,2209,0.774509804,0.219205631,0.555304173
Texas,48177,Gonzales County,5568,1894,7534,3674,0.739049642,0.251393682,0.48765596
Texas,48179,Gray County,6812,820,7745,5992,0.879535184,0.105874758,0.773660426
Texas,48181,Grayson County,43776,14223,58760,29553,0.744996596,0.242052417,0.50294418
Texas,48183,Gregg County,32352,14657,47700,17695,0.678238994,0.307274633,0.370964361
Texas,48185,Grimes County,9419,2831,12398,6588,0.75971931,0.228343281,0.531376028
Texas,48187,Guadalupe County,47423,28706,77382,18717,0.61284278,0.370964824,0.241877956
Texas,48189,Hale County,7162,2271,9560,4891,0.74916318,0.237552301,0.511610879
Texas,48191,Hall County,992,167,1165,825,0.851502146,0.143347639,0.708154506
Texas,48193,Hamilton County,3613,641,4347,2972,0.831147918,0.147458017,0.683689901
Texas,48195,Hansford County,1848,166,2046,1682,0.903225806,0.08113392,0.822091887
Texas,48197,Hardeman County,1330,241,1580,1089,0.841772152,0.152531646,0.689240506
Texas,48199,Hardin County,23806,3449,27555,20357,0.863944838,0.125167846,0.738776991
Texas,48201,Harris County,699822,911974,1633671,-212152,0.428373889,0.558236022,-0.129862133
Texas,48203,Harrison County,21318,7812,29462,13506,0.723576132,0.265155115,0.458421017
Texas,48205,Hartley County,1866,195,2076,1671,0.898843931,0.093930636,0.804913295
Texas,48207,Haskell County,1837,353,2211,1484,0.830845771,0.159656264,0.671189507
Texas,48209,Hays County,47427,59213,108822,-11786,0.435821801,0.544127107,-0.108305306
Texas,48211,Hemphill County,1486,206,1720,1280,0.863953488,0.119767442,0.744186047
Texas,48213,Henderson County,28816,7048,36197,21768,0.796088074,0.194712269,0.601375805
Texas,48215,Hidalgo County,89991,127507,219939,-37516,0.40916345,0.579738018,-0.170574568
Texas,48217,Hill County,11869,2829,14843,9040,0.799636192,0.190594893,0.609041299
Texas,48219,Hockley County,6534,1481,8091,5053,0.80756396,0.183042887,0.624521073
Texas,48221,Hood County,26487,5641,32580,20846,0.812983425,0.173143033,0.639840393
Texas,48223,Hopkins County,12713,3043,15932,9670,0.797953804,0.190999247,0.606954557
Texas,48225,Houston County,7050,2312,9426,4738,0.747931254,0.245279015,0.502652238
Texas,48227,Howard County,7899,2017,10043,5882,0.786517973,0.200836403,0.585681569
Texas,48229,Hudspeth County,771,371,1157,400,0.666378565,0.320656871,0.345721694
Texas,48231,Hunt County,29135,8879,38517,20256,0.756419243,0.230521588,0.525897656
Texas,48233,Hutchinson County,7659,957,8741,6702,0.876215536,0.109484041,0.766731495
Texas,48235,Irion County,759,120,889,639,0.853768279,0.134983127,0.718785152
Texas,48237,Jack County,3415,331,3779,3084,0.903678222,0.087589309,0.816088912
Texas,48239,Jackson County,5116,1018,6210,4098,0.823832528,0.163929147,0.659903382
Texas,48241,Jasper County,12453,2906,15469,9547,0.805029414,0.18785959,0.617169824
Texas,48243,Jeff Davis County,783,501,1304,282,0.600460123,0.384202454,0.216257669
Texas,48245,Jefferson County,47535,46022,94665,1513,0.502139122,0.486156446,0.015982676
Texas,48247,Jim Hogg County,831,1197,2034,-366,0.408554572,0.588495575,-0.179941003
Texas,48249,Jim Wells County,7389,6025,13507,1364,0.547049678,0.446065003,0.100984675
Texas,48251,Johnson County,54523,16418,71928,38105,0.758021911,0.228256034,0.529765877
Texas,48253,Jones County,5621,989,6691,4632,0.840083695,0.147810492,0.692273203
Texas,48255,Karnes County,3959,1220,5229,2739,0.757123733,0.233314209,0.523809524
Texas,48257,Kaufman County,37474,18290,56435,19184,0.664020555,0.324089661,0.339930894
Texas,48259,Kendall County,20064,6008,26419,14056,0.759453424,0.22741209,0.532041334
Texas,48261,Kenedy County,127,65,194,62,0.654639175,0.335051546,0.319587629
Texas,48263,Kent County,411,47,462,364,0.88961039,0.101731602,0.787878788
Texas,48265,Kerr County,20858,6510,27738,14348,0.751964814,0.234696085,0.517268729
Texas,48267,Kimble County,1987,284,2292,1703,0.866928447,0.12390925,0.743019197
Texas,48269,King County,151,8,159,143,0.949685535,0.050314465,0.899371069
Texas,48271,Kinney County,1144,446,1603,698,0.713661884,0.278228322,0.435433562
Texas,48273,Kleberg County,5557,5359,11041,198,0.50330586,0.485372702,0.017933158
Texas,48275,Knox County,1180,265,1456,915,0.81043956,0.182005495,0.628434066
Texas,48277,Lamar County,16698,4420,21338,12278,0.782547568,0.207142188,0.57540538
Texas,48279,Lamb County,3513,835,4394,2678,0.799499317,0.190031862,0.609467456
Texas,48281,Lampasas County,8070,2134,10373,5936,0.777981298,0.205726405,0.572254893
Texas,48283,La Salle County,1335,1052,2406,283,0.554862843,0.437240233,0.11762261
Texas,48285,Lavaca County,8802,1333,10195,7469,0.863364394,0.130750368,0.732614026
Texas,48287,Lee County,6248,1745,8075,4503,0.77374613,0.216099071,0.557647059
Texas,48289,Leon County,7522,1072,8672,6450,0.867389299,0.123616236,0.743773063
Texas,48291,Liberty County,23288,5779,29314,17509,0.794432694,0.197141298,0.597291397
Texas,48293,Limestone County,6786,2213,9092,4573,0.746370436,0.243400792,0.502969644
Texas,48295,Lipscomb County,1203,131,1351,1072,0.890451517,0.096965211,0.793486306
Texas,48297,Live Oak County,4198,819,5053,3379,0.830793588,0.162081932,0.668711656
Texas,48299,Llano County,9996,3167,13278,6829,0.752824221,0.238514837,0.514309384
Texas,48301,Loving County,60,4,66,56,0.909090909,0.060606061,0.848484848
Texas,48303,Lubbock County,78560,39757,120204,38803,0.653555622,0.330746065,0.322809557
Texas,48305,Lynn County,1853,428,2293,1425,0.808111644,0.186655037,0.621456607
Texas,48307,McCulloch County,2898,490,3430,2408,0.844897959,0.142857143,0.702040816
Texas,48309,McLennan County,59432,36550,97617,22882,0.60882838,0.374422488,0.234405892
Texas,48311,McMullen County,460,53,516,407,0.891472868,0.102713178,0.78875969
Texas,48313,Madison County,4165,1084,5289,3081,0.787483456,0.204953677,0.582529779
Texas,48315,Marion County,3459,1331,4844,2128,0.714079273,0.274772915,0.439306358
Texas,48317,Martin County,1857,288,2160,1569,0.859722222,0.133333333,0.726388889
Texas,48319,Mason County,2108,566,2700,1542,0.780740741,0.20962963,0.571111111
Texas,48321,Matagorda County,9836,3726,13710,6110,0.717432531,0.271772429,0.445660102
Texas,48323,Maverick County,6881,8324,15338,-1443,0.448624332,0.542704394,-0.094080063
Texas,48325,Medina County,15599,6731,22568,8868,0.691199929,0.298254165,0.392945764
Texas,48327,Menard County,819,196,1023,623,0.80058651,0.191593353,0.608993157
Texas,48329,Midland County,45463,12258,58752,33205,0.773811955,0.208639706,0.565172249
Texas,48331,Milam County,7950,2475,10523,5475,0.755487979,0.235199088,0.520288891
Texas,48333,Mills County,2214,271,2502,1943,0.884892086,0.108313349,0.776578737
Texas,48335,Mitchell County,2169,397,2579,1772,0.841023653,0.153935634,0.687088019
Texas,48337,Montague County,8613,1097,9812,7516,0.877802691,0.111801875,0.766000815
Texas,48339,Montgomery County,193224,74255,271175,118969,0.71254356,0.273826865,0.438716696
Texas,48341,Moore County,4356,1059,5502,3297,0.791712105,0.192475463,0.599236641
Texas,48343,Morris County,3841,1664,5548,2177,0.692321557,0.299927902,0.392393655
Texas,48345,Motley County,604,46,652,558,0.926380368,0.070552147,0.855828221
Texas,48347,Nacogdoches County,17359,8989,26755,8370,0.648813306,0.335974584,0.312838722
Texas,48349,Navarro County,13787,5097,19105,8690,0.721643549,0.266788799,0.45485475
Texas,48351,Newton County,4882,1175,6096,3707,0.800853018,0.192749344,0.608103675
Texas,48353,Nolan County,4127,1161,5352,2966,0.771113602,0.216928251,0.554185351
Texas,48355,Nueces County,64467,60749,126984,3718,0.507678133,0.478398853,0.029279279
Texas,48357,Ochiltree County,2811,302,3155,2509,0.890966719,0.095721078,0.795245642
Texas,48359,Oldham County,917,81,1009,836,0.908820614,0.080277502,0.828543112
Texas,48361,Orange County,29170,6354,35974,22816,0.810863401,0.176627564,0.634235837
Texas,48363,Palo Pinto County,10170,2177,12478,7993,0.815034461,0.174467062,0.640567399
Texas,48365,Panola County,9322,2057,11452,7265,0.814006287,0.17961928,0.634387007
Texas,48367,Parker County,61584,12789,75434,48795,0.81639579,0.169538935,0.646856855
Texas,48369,Parmer County,2133,488,2648,1645,0.805513595,0.18429003,0.621223565
Texas,48371,Pecos County,3213,1378,4668,1835,0.688303342,0.295201371,0.393101971
Texas,48373,Polk County,18496,5353,24072,13143,0.768361582,0.222374543,0.545987039
Texas,48375,Potter County,22732,9867,33242,12865,0.683833704,0.296823296,0.387010409
Texas,48377,Presidio County,721,1463,2217,-742,0.325214253,0.659900767,-0.334686513
Texas,48379,Rains County,5147,841,6044,4306,0.851588352,0.139146261,0.712442091
Texas,48381,Randall County,57695,11414,69973,46281,0.82453232,0.163120061,0.661412259
Texas,48383,Reagan County,942,172,1124,770,0.838078292,0.153024911,0.685053381
Texas,48385,Real County,1643,320,1982,1323,0.828960646,0.161453078,0.667507568
Texas,48387,Red River County,4513,1244,5800,3269,0.778103448,0.214482759,0.56362069
Texas,48389,Reeves County,2249,1394,3683,855,0.610643497,0.378495791,0.232147706
Texas,48391,Refugio County,2210,1108,3366,1102,0.656565657,0.329174094,0.327391563
Texas,48393,Roberts County,529,17,550,512,0.961818182,0.030909091,0.930909091
Texas,48395,Robertson County,5631,2359,8080,3272,0.696905941,0.291955446,0.404950495
Texas,48397,Rockwall County,38842,18149,57792,20693,0.672099945,0.314040006,0.358059939
Texas,48399,Runnels County,3682,531,4262,3151,0.863913656,0.124589395,0.739324261
Texas,48401,Rusk County,16511,4624,21367,11887,0.772733655,0.21640848,0.556325174
Texas,48403,Sabine County,4767,662,5462,4105,0.872757232,0.121201025,0.751556207
Texas,48405,San Augustine County,3005,979,3998,2026,0.751625813,0.244872436,0.506753377
Texas,48407,San Jacinto County,10154,2332,12628,7822,0.804086158,0.18466899,0.619417168
Texas,48409,San Patricio County,16495,8971,25850,7524,0.638104449,0.347040619,0.29106383
Texas,48411,San Saba County,2308,287,2602,2021,0.887009992,0.110299769,0.776710223
Texas,48413,Schleicher County,939,211,1158,728,0.810880829,0.182210708,0.628670121
Texas,48415,Scurry County,4978,818,5865,4160,0.848763853,0.139471441,0.709292413
Texas,48417,Shackelford County,1484,130,1628,1354,0.911547912,0.07985258,0.831695332
Texas,48419,Shelby County,7962,2058,10063,5904,0.791215343,0.204511577,0.586703766
Texas,48421,Sherman County,885,91,990,794,0.893939394,0.091919192,0.802020202
Texas,48423,Smith County,68546,29343,99521,39203,0.688759156,0.294842295,0.393916862
Texas,48425,Somervell County,4099,768,4940,3331,0.829757085,0.155465587,0.674291498
Texas,48427,Starr County,8224,9099,17478,-875,0.470534386,0.520597322,-0.050062936
Texas,48429,Stephens County,3385,396,3799,2989,0.891023954,0.104237957,0.786785996
Texas,48431,Sterling County,584,51,639,533,0.913928013,0.079812207,0.834115806
Texas,48433,Stonewall County,615,116,736,499,0.835597826,0.157608696,0.67798913
Texas,48435,Sutton County,1222,322,1557,900,0.784842646,0.206807964,0.578034682
Texas,48437,Swisher County,1842,478,2353,1364,0.782830429,0.203144921,0.579685508
Texas,48439,Tarrant County,407702,409067,830104,-1365,0.491145688,0.49279006,-0.001644372
Texas,48441,Taylor County,39439,14489,54924,24950,0.718064962,0.263800889,0.454264074
Texas,48443,Terrell County,334,119,458,215,0.729257642,0.259825328,0.469432314
Texas,48445,Terry County,2809,757,3608,2052,0.778547672,0.20981153,0.568736142
Texas,48447,Throckmorton County,806,82,899,724,0.896551724,0.091212458,0.805339266
Texas,48449,Titus County,7563,2852,10530,4711,0.718233618,0.270845204,0.447388414
Texas,48451,Tom Green County,32129,12106,44891,20023,0.71571139,0.269675436,0.446035954
Texas,48453,Travis County,159907,432062,605034,-272155,0.264294238,0.714111934,-0.449817696
Texas,48455,Trinity County,5579,1323,6938,4256,0.804122225,0.190688959,0.613433266
Texas,48457,Tyler County,8095,1390,9547,6705,0.847910338,0.145595475,0.702314863
Texas,48459,Upshur County,15775,2869,18850,12906,0.836870027,0.152201592,0.684668435
Texas,48461,Upton County,1176,169,1365,1007,0.861538462,0.123809524,0.737728938
Texas,48463,Uvalde County,6160,4066,10323,2094,0.596725758,0.393877749,0.202848009
Texas,48465,Val Verde County,7839,6401,14417,1438,0.543733093,0.443989734,0.099743359
Texas,48467,Van Zandt County,22126,3419,25753,18707,0.859162039,0.132761232,0.726400808
Texas,48469,Victoria County,23347,10371,34205,12976,0.682561029,0.303201286,0.379359743
Texas,48471,Walker County,15368,7875,23641,7493,0.650057104,0.333107737,0.316949368
Texas,48473,Waller County,14206,8130,22617,6076,0.628111597,0.35946412,0.268647478
Texas,48475,Ward County,3238,761,4034,2477,0.802677243,0.188646505,0.614030739
Texas,48477,Washington County,12949,4254,17410,8695,0.743767949,0.244342332,0.499425617
Texas,48479,Webb County,25898,41820,68439,-15922,0.378409971,0.6110551,-0.232645129
Texas,48481,Wharton County,11892,4671,16709,7221,0.711712251,0.279549943,0.432162308
Texas,48483,Wheeler County,2158,168,2336,1990,0.92380137,0.071917808,0.851883562
Texas,48485,Wichita County,31930,13024,45753,18906,0.697877735,0.284658929,0.413218805
Texas,48487,Wilbarger County,3520,954,4518,2566,0.779105799,0.211155378,0.567950421
Texas,48489,Willacy County,2437,3097,5575,-660,0.437130045,0.555515695,-0.11838565
Texas,48491,Williamson County,138649,142457,287696,-3808,0.481928842,0.495165035,-0.013236194
Texas,48493,Wilson County,18457,6350,25006,12107,0.738102855,0.253939055,0.484163801
Texas,48495,Winkler County,1753,358,2126,1395,0.824553151,0.168391345,0.656161806
Texas,48497,Wise County,26986,4953,32297,22033,0.835557482,0.153357897,0.682199585
Texas,48499,Wood County,18962,3487,22665,15475,0.83662034,0.153849548,0.682770792
Texas,48501,Yoakum County,2172,419,2633,1753,0.824914546,0.159134068,0.665780479
Texas,48503,Young County,7112,1036,8242,6076,0.862897355,0.125697646,0.737199709
Texas,48505,Zapata County,2032,1820,3867,212,0.525471942,0.470649082,0.05482286
Texas,48507,Zavala County,1490,2864,4379,-1374,0.340260333,0.654030601,-0.313770267
Utah,49001,Beaver County,2673,356,3076,2317,0.868985696,0.11573472,0.753250975
Utah,49003,Box Elder County,20660,4280,26027,16380,0.793791063,0.164444615,0.629346448
Utah,49005,Cache County,34377,15246,52792,19131,0.651178209,0.288793757,0.362384452
Utah,49007,Carbon County,6255,2306,8822,3949,0.709022897,0.261391975,0.447630923
Utah,49009,Daggett County,473,105,590,368,0.801694915,0.177966102,0.623728814
Utah,49011,Davis County,89326,51697,147774,37629,0.604477107,0.349838267,0.25463884
Utah,49013,Duchesne County,7445,830,8476,6615,0.878362435,0.097923549,0.780438886
Utah,49015,Emery County,4166,566,4816,3600,0.865033223,0.117524917,0.747508306
Utah,49017,Garfield County,2149,513,2722,1636,0.78949302,0.188464364,0.601028655
Utah,49019,Grand County,2168,2733,5027,-565,0.431271136,0.543664213,-0.112393077
Utah,49021,Iron County,18113,4673,23731,13440,0.763263242,0.196915427,0.566347815
Utah,49023,Juab County,5069,638,5875,4431,0.862808511,0.108595745,0.754212766
Utah,49025,Kane County,2777,1005,3869,1772,0.717756526,0.259757043,0.457999483
Utah,49027,Millard County,4267,529,4887,3738,0.873132801,0.108246368,0.764886433
Utah,49029,Morgan County,4957,1060,6254,3897,0.792612728,0.169491525,0.623121202
Utah,49031,Piute County,773,86,871,687,0.887485649,0.098737084,0.788748565
Utah,49033,Rich County,1118,178,1320,940,0.846969697,0.134848485,0.712121212
Utah,49035,Salt Lake County,162607,226446,404685,-63839,0.401811285,0.55956114,-0.157749855
Utah,49037,San Juan County,2634,2451,5243,183,0.502384131,0.46748045,0.034903681
Utah,49039,Sanpete County,9961,1724,12133,8237,0.820984093,0.142091816,0.678892277
Utah,49041,Sevier County,8427,1032,9731,7395,0.865995273,0.106052821,0.759942452
Utah,49043,Summit County,6122,11733,18130,-5611,0.337672366,0.647159404,-0.309487038
Utah,49045,Tooele County,19531,8498,29770,11033,0.656063151,0.285455156,0.370607995
Utah,49047,Uintah County,12777,1601,14796,11176,0.863544201,0.10820492,0.755339281
Utah,49049,Utah County,173856,69386,259688,104470,0.669480299,0.267189859,0.402290441
Utah,49051,Wasatch County,9953,5762,16456,4191,0.604824988,0.350145843,0.254679144
Utah,49053,Washington County,65601,20065,88807,45536,0.73869177,0.225939397,0.512752373
Utah,49055,Wayne County,1207,362,1596,845,0.756265664,0.226817043,0.529448622
Utah,49057,Weber County,64066,39652,108335,24414,0.591369364,0.366012831,0.225356533
Vermont,50001,Addison County,6292,14964,22029,-8672,0.285623496,0.679286395,-0.393662899
Vermont,50003,Bennington County,7096,12591,20340,-5495,0.348869223,0.619026549,-0.270157325
Vermont,50005,Caledonia County,6551,9010,16186,-2459,0.404732485,0.556653898,-0.151921414
Vermont,50007,Chittenden County,19614,59573,81662,-39959,0.240185153,0.729506992,-0.489321839
Vermont,50009,Essex County,1773,1405,3288,368,0.539233577,0.427311436,0.111922141
Vermont,50011,Franklin County,11267,13576,25820,-2309,0.436367157,0.525793958,-0.089426801
Vermont,50013,Grand Isle County,1810,2905,4863,-1095,0.372198232,0.59736788,-0.225169648
Vermont,50015,Lamoille County,4163,10240,14951,-6077,0.278442914,0.68490402,-0.406461106
Vermont,50017,Orange County,6178,10281,17101,-4103,0.361265423,0.601192913,-0.23992749
Vermont,50019,Orleans County,6512,7147,14103,-635,0.461745728,0.506771609,-0.045025881
Vermont,50021,Rutland County,14652,18205,33946,-3553,0.431626701,0.536292936,-0.104666235
Vermont,50023,Washington County,8925,25169,35304,-16244,0.252804215,0.712922048,-0.460117834
Vermont,50025,Windham County,6308,18766,26078,-12458,0.241889715,0.7196104,-0.477720684
Vermont,50027,Windsor County,9990,23399,34507,-13409,0.289506477,0.6780943,-0.388587823
Virginia,51001,Accomack County,9172,7578,16959,1594,0.540833776,0.446842385,0.093991391
Virginia,51003,Albemarle County,20711,42132,64209,-21421,0.322556028,0.656169696,-0.333613668
Virginia,51005,Alleghany County,5859,2243,8191,3616,0.715297277,0.273837138,0.441460139
Virginia,51007,Amelia County,5370,2390,7837,2980,0.685211178,0.304963634,0.380247544
Virginia,51009,Amherst County,11053,5680,16985,5373,0.650750662,0.334412717,0.316337945
Virginia,51011,Appomattox County,6702,2418,9268,4284,0.723133362,0.260897713,0.46223565
Virginia,51013,Arlington County,22205,105167,129202,-82962,0.171862665,0.813973468,-0.642110803
Virginia,51015,Augusta County,30556,10748,41898,19808,0.729294954,0.256527758,0.472767197
Virginia,51017,Bath County,1824,674,2513,1150,0.725825706,0.268205332,0.457620374
Virginia,51019,Bedford County,35369,11986,48041,23383,0.736225308,0.249495223,0.486730085
Virginia,51021,Bland County,2903,532,3475,2371,0.835395683,0.153093525,0.682302158
Virginia,51023,Botetourt County,15033,5637,20924,9396,0.718457274,0.269403556,0.449053718
Virginia,51025,Brunswick County,3343,4533,7915,-1190,0.422362603,0.572710044,-0.150347442
Virginia,51027,Buchanan County,8311,1587,9953,6724,0.835024616,0.159449412,0.675575203
Virginia,51029,Buckingham County,4544,3471,8108,1073,0.560434139,0.428095708,0.132338431
Virginia,51031,Campbell County,21211,8041,29739,13170,0.713238508,0.270385689,0.44285282
Virginia,51033,Caroline County,8109,7733,16097,376,0.503758464,0.480400075,0.02335839
Virginia,51035,Carroll County,12659,2842,15619,9817,0.810487227,0.181957872,0.628529355
Virginia,51036,Charles City County,1761,2624,4439,-863,0.396710971,0.591124127,-0.194413156
Virginia,51037,Charlotte County,3815,2317,6191,1498,0.616217089,0.374252948,0.241964141
Virginia,51041,Chesterfield County,98541,111094,212576,-12553,0.463556563,0.522608385,-0.059051821
Virginia,51043,Clarke County,5192,3920,9290,1272,0.558880517,0.421959096,0.136921421
Virginia,51045,Craig County,2536,587,3163,1949,0.801770471,0.185583307,0.616187164
Virginia,51047,Culpeper County,16013,10617,27117,5396,0.590515175,0.391525611,0.198989564
Virginia,51049,Cumberland County,3019,2230,5302,789,0.569407771,0.420596002,0.148811769
Virginia,51051,Dickenson County,5746,1501,7299,4245,0.787231128,0.205644609,0.581586519
Virginia,51053,Dinwiddie County,8695,6224,15063,2471,0.577242249,0.413197902,0.164044347
Virginia,51057,Essex County,3075,3038,6171,37,0.498298493,0.492302706,0.005995787
Virginia,51059,Fairfax County,162312,404886,578931,-242574,0.280365018,0.699368319,-0.419003301
Virginia,51061,Fauquier County,25133,17362,43260,7771,0.580975497,0.40134073,0.179634767
Virginia,51063,Floyd County,6189,2970,9329,3219,0.663415157,0.318362097,0.34505306
Virginia,51065,Fluvanna County,8071,7289,15620,782,0.516709347,0.466645327,0.05006402
Virginia,51067,Franklin County,20797,8312,29459,12485,0.705964221,0.282154859,0.423809362
Virginia,51069,Frederick County,30126,16021,46918,14105,0.642098981,0.341468093,0.300630888
Virginia,51071,Giles County,6876,2156,9157,4720,0.75090095,0.235448291,0.515452659
Virginia,51073,Gloucester County,14875,6964,22228,7911,0.669201008,0.313298542,0.355902465
Virginia,51075,Goochland County,9896,6623,16759,3273,0.590488693,0.395190644,0.195298049
Virginia,51077,Grayson County,6529,1535,8120,4994,0.804064039,0.189039409,0.615024631
Virginia,51079,Greene County,6819,4089,11144,2730,0.61189878,0.366923905,0.244974874
Virginia,51081,Greensville County,1914,2627,4565,-713,0.419277108,0.575465498,-0.15618839
Virginia,51083,Halifax County,10404,7648,18192,2756,0.571899736,0.420404573,0.151495163
Virginia,51085,Hanover County,44318,25307,70728,19011,0.62659767,0.357807375,0.268790295
Virginia,51087,Henrico County,61280,110115,173610,-48835,0.352975059,0.634266459,-0.2812914
Virginia,51089,Henry County,16725,9127,26075,7598,0.641418984,0.350028763,0.291390221
Virginia,51091,Highland County,1092,417,1531,675,0.713259308,0.272370999,0.440888308
Virginia,51093,Isle of Wight County,13661,9346,23330,4315,0.585555079,0.400600086,0.184954994
Virginia,51095,James City County,23059,25374,49314,-2315,0.467595409,0.514539482,-0.046944073
Virginia,51097,King and Queen County,2450,1590,4104,860,0.596978558,0.387426901,0.209551657
Virginia,51099,King George County,8446,5404,14164,3042,0.59630048,0.381530641,0.214769839
Virginia,51101,King William County,7320,3260,10733,4060,0.682008758,0.303736141,0.378272617
Virginia,51103,Lancaster County,3694,3361,7126,333,0.518383385,0.471653101,0.046730283
Virginia,51105,Lee County,8365,1489,9932,6876,0.842227145,0.149919452,0.692307692
Virginia,51107,Loudoun County,81837,137827,224036,-55990,0.365285043,0.615200236,-0.249915192
Virginia,51109,Louisa County,13294,8269,21914,5025,0.606644154,0.377338688,0.229305467
Virginia,51111,Lunenburg County,3586,2413,6038,1173,0.593905267,0.399635641,0.194269626
Virginia,51113,Madison County,5294,2684,8108,2610,0.652935372,0.33103108,0.321904292
Virginia,51115,Mathews County,3900,1824,5824,2076,0.669642857,0.313186813,0.356456044
Virginia,51117,Mecklenburg County,9266,6803,16182,2463,0.572611544,0.420405389,0.152206155
Virginia,51119,Middlesex County,4196,2491,6764,1705,0.620342992,0.368273211,0.252069781
Virginia,51121,Montgomery County,20573,23077,44573,-2504,0.461557445,0.517734952,-0.056177507
Virginia,51125,Nelson County,4799,4307,9335,492,0.51408677,0.461381896,0.052704874
Virginia,51127,New Kent County,8929,3162,12224,5767,0.730448298,0.258671466,0.471776832
Virginia,51131,Northampton County,2955,3667,6722,-712,0.439601309,0.545522166,-0.105920857
Virginia,51133,Northumberland County,4477,3240,7772,1237,0.576042203,0.416881112,0.159161091
Virginia,51135,Nottoway County,4032,2976,7080,1056,0.569491525,0.420338983,0.149152542
Virginia,51137,Orange County,12426,7995,20688,4431,0.600638051,0.386455916,0.214182135
Virginia,51139,Page County,9316,2982,12432,6334,0.749356499,0.239864865,0.509491634
Virginia,51141,Patrick County,7474,1948,9527,5526,0.78450719,0.204471502,0.580035688
Virginia,51143,Pittsylvania County,23704,10053,34041,13651,0.69633677,0.295320349,0.401016421
Virginia,51145,Powhatan County,14055,5320,19730,8735,0.712366954,0.269640142,0.442726812
Virginia,51147,Prince Edward County,4434,4973,9543,-539,0.464633763,0.521114953,-0.05648119
Virginia,51149,Prince George County,10106,6870,17182,3236,0.58817367,0.399837039,0.188336631
Virginia,51153,Prince William County,76432,139502,219075,-63070,0.348885085,0.636777359,-0.287892274
Virginia,51155,Pulaski County,12127,4925,17376,7202,0.697916667,0.283436924,0.414479742
Virginia,51157,Rappahannock County,2815,2096,4967,719,0.566740487,0.421985102,0.144755386
Virginia,51159,Richmond County,2547,1513,4091,1034,0.622586165,0.369836226,0.252749939
Virginia,51161,Roanoke County,33758,21218,55845,12540,0.604494583,0.379944489,0.224550094
Virginia,51163,Rockbridge County,8047,4022,12368,4025,0.65063066,0.325194049,0.325436611
Virginia,51165,Rockingham County,28608,9311,38622,19297,0.740717726,0.241080213,0.499637512
Virginia,51167,Russell County,10879,2373,13368,8506,0.813809096,0.177513465,0.636295631
Virginia,51169,Scott County,9063,1692,10845,7371,0.835684647,0.156016598,0.67966805
Virginia,51171,Shenandoah County,16398,6781,23522,9617,0.697134597,0.288283309,0.408851288
Virginia,51173,Smyth County,10941,2989,14057,7952,0.778331081,0.212634275,0.565696806
Virginia,51175,Southampton County,5730,3969,9786,1761,0.585530349,0.405579399,0.17995095
Virginia,51177,Spotsylvania County,39506,34385,75302,5121,0.52463414,0.456627978,0.068006162
Virginia,51179,Stafford County,37513,40138,79021,-2625,0.474721909,0.507940927,-0.033219018
Virginia,51181,Surry County,2025,2397,4462,-372,0.453832362,0.537203048,-0.083370686
Virginia,51183,Sussex County,2217,2822,5081,-605,0.436331431,0.55540248,-0.119071049
Virginia,51185,Tazewell County,16665,3169,19989,13496,0.83370854,0.158537195,0.675171344
Virginia,51187,Warren County,14033,6564,20959,7469,0.669545303,0.313182881,0.356362422
Virginia,51191,Washington County,21678,6617,28684,15061,0.755752336,0.230686097,0.525066239
Virginia,51193,Westmoreland County,5286,4453,9853,833,0.536486349,0.45194357,0.084542779
Virginia,51195,Wise County,13315,3084,16505,10231,0.806725235,0.186852469,0.619872766
Virginia,51197,Wythe County,11733,3143,15046,8590,0.779808587,0.208892729,0.570915858
Virginia,51199,York County,20087,17410,38165,2677,0.526319927,0.456177126,0.070142801
Virginia,51510,Alexandria city,14251,65201,80425,-50950,0.177196145,0.810705626,-0.633509481
Virginia,51520,Bristol city,5347,2313,7802,3034,0.685337093,0.296462446,0.388874648
Virginia,51530,Buena Vista city,1863,825,2815,1038,0.661811723,0.293072824,0.368738899
Virginia,51540,Charlottesville city,3094,20696,24101,-17602,0.128376416,0.858719555,-0.730343139
Virginia,51550,Chesapeake city,57651,65330,125009,-7679,0.461174795,0.522602373,-0.061427577
Virginia,51570,Colonial Heights city,6007,2972,9114,3035,0.659095896,0.326091727,0.333004169
Virginia,51580,Covington city,1580,964,2594,616,0.609097918,0.371626831,0.237471087
Virginia,51590,Danville city,7396,11615,19204,-4219,0.385128098,0.604821912,-0.219693814
Virginia,51595,Emporia city,754,1612,2379,-858,0.316939891,0.677595628,-0.360655738
Virginia,51600,Fairfax city,3982,9120,13303,-5138,0.299330978,0.685559648,-0.38622867
Virginia,51610,Falls Church city,1490,7146,8750,-5656,0.170285714,0.816685714,-0.6464
Virginia,51620,Franklin city,1482,2505,4031,-1023,0.367650707,0.621433887,-0.25378318
Virginia,51630,Fredericksburg city,4037,8517,12794,-4480,0.315538534,0.665702673,-0.350164139
Virginia,51640,Galax city,1836,775,2629,1061,0.698364397,0.294788893,0.403575504
Virginia,51650,Hampton city,18201,45481,64654,-27280,0.281513905,0.703452223,-0.421938318
Virginia,51660,Harrisonburg city,5560,10935,16851,-5375,0.329950745,0.648922913,-0.318972168
Virginia,51670,Hopewell city,4018,5427,9630,-1409,0.417237799,0.563551402,-0.146313603
Virginia,51678,Lexington city,901,1782,2731,-881,0.329915782,0.652508239,-0.322592457
Virginia,51680,Lynchburg city,16697,17447,35866,-750,0.465538393,0.486449562,-0.020911169
Virginia,51683,Manassas city,6182,10100,16555,-3918,0.373421927,0.610087587,-0.23666566
Virginia,51685,Manassas Park city,2062,3913,6071,-1851,0.339647505,0.644539615,-0.30489211
Virginia,51690,Martinsville city,2165,3766,6004,-1601,0.360592938,0.627248501,-0.266655563
Virginia,51700,Newport News city,25594,50319,77859,-24725,0.328722434,0.646283667,-0.317561232
Virginia,51710,Norfolk city,22038,59396,83041,-37358,0.265386978,0.715261136,-0.449874159
Virginia,51720,Norton city,1112,464,1597,648,0.696305573,0.290544771,0.405760802
Virginia,51730,Petersburg city,1573,12293,13973,-10720,0.11257425,0.879768124,-0.767193874
Virginia,51735,Poquoson city,5605,2054,7819,3551,0.716843586,0.262693439,0.454150147
Virginia,51740,Portsmouth city,12755,30948,44576,-18193,0.286140524,0.694274946,-0.408134422
Virginia,51750,Radford city,2786,3358,6289,-572,0.442995707,0.533948163,-0.090952457
Virginia,51760,Richmond city,15707,86460,103917,-70753,0.151149475,0.832010162,-0.680860687
Virginia,51770,Roanoke city,15356,25929,42033,-10573,0.365332001,0.616872457,-0.251540456
Virginia,51775,Salem city,7683,5148,13051,2535,0.588690522,0.394452532,0.194237989
Virginia,51790,Staunton city,5642,6886,12781,-1244,0.441436507,0.538768484,-0.097331977
Virginia,51800,Suffolk city,20006,28484,49213,-8478,0.406518603,0.578790157,-0.172271554
Virginia,51810,Virginia Beach city,115107,134252,253477,-19145,0.454112207,0.529641743,-0.075529535
Virginia,51820,Waynesboro city,5474,4918,10638,556,0.514570408,0.462304945,0.052265463
Virginia,51830,Williamsburg city,1963,4790,6845,-2827,0.286778671,0.699780862,-0.413002191
Virginia,51840,Winchester city,5156,6451,11812,-1295,0.436505249,0.546139519,-0.10963427
Washington,53001,Adams County,3449,1562,5109,1887,0.675083187,0.305734977,0.369348209
Washington,53003,Asotin County,7259,4233,11847,3026,0.612728961,0.357305647,0.255423314
Washington,53005,Benton County,59588,37859,101066,21729,0.589594918,0.374596798,0.21499812
Washington,53007,Chelan County,22476,19005,42548,3471,0.528250447,0.446671994,0.081578453
Washington,53009,Clallam County,20131,22535,43697,-2404,0.460695242,0.515710461,-0.055015218
Washington,53011,Clark County,124756,138612,270039,-13856,0.461992527,0.513303634,-0.051311107
Washington,53013,Columbia County,1699,644,2397,1055,0.70880267,0.26866917,0.4401335
Washington,53015,Cowlitz County,33976,23631,59164,10345,0.574268136,0.399415185,0.174852951
Washington,53017,Douglas County,12619,7554,20567,5065,0.613555696,0.367287402,0.246268294
Washington,53019,Ferry County,2735,1465,4308,1270,0.634865367,0.340064995,0.294800371
Washington,53021,Franklin County,17583,12786,31330,4797,0.561219279,0.408107245,0.153112033
Washington,53023,Garfield County,1062,362,1478,700,0.718538566,0.244925575,0.473612991
Washington,53025,Grant County,16662,8386,25575,8276,0.651495601,0.327898338,0.323597263
Washington,53027,Grays Harbor County,18960,16623,36652,2337,0.517297828,0.45353596,0.063761868
Washington,53029,Island County,22535,29003,53089,-6468,0.42447588,0.546309028,-0.121833148
Washington,53031,Jefferson County,6531,16578,23580,-10047,0.27697201,0.703053435,-0.426081425
Washington,53033,King County,262428,891510,1178868,-629082,0.222610165,0.756242429,-0.533632264
Washington,53035,Kitsap County,60838,89373,155853,-28535,0.390355014,0.573444207,-0.183089193
Washington,53037,Kittitas County,13778,11004,25579,2774,0.538644982,0.430196646,0.108448337
Washington,53039,Klickitat County,6203,5216,11621,987,0.533775062,0.448842613,0.08493245
Washington,53041,Lewis County,29074,14316,44735,14758,0.649916173,0.320017883,0.32989829
Washington,53043,Lincoln County,5095,1694,6942,3401,0.733938346,0.244021896,0.489916451
Washington,53045,Mason County,18342,16999,36572,1343,0.501531226,0.464809144,0.036722082
Washington,53047,Okanogan County,9231,7469,16985,1762,0.543479541,0.439740948,0.103738593
Washington,53049,Pacific County,6930,6776,14011,154,0.494611377,0.483620013,0.010991364
Washington,53051,Pend Oreille County,5655,2578,8422,3077,0.671455711,0.306103063,0.365352648
Washington,53053,Pierce County,193795,244893,453965,-51098,0.426894144,0.539453482,-0.112559338
Washington,53055,San Juan County,2994,9606,12977,-6612,0.230715882,0.740232719,-0.509516837
Washington,53057,Skagit County,19598,26753,47259,-7155,0.414693498,0.566093231,-0.151399733
Washington,53059,Skamania County,3694,3016,6918,678,0.533969355,0.435964151,0.098005204
Washington,53061,Snohomish County,162972,251625,428889,-88653,0.37998643,0.586690263,-0.206703832
Washington,53063,Spokane County,146805,133892,291049,12913,0.504399603,0.460032503,0.0443671
Washington,53065,Stevens County,14566,6563,21581,8003,0.674945554,0.304110097,0.370835457
Washington,53067,Thurston County,58200,89778,152918,-31578,0.380596136,0.587098968,-0.206502832
Washington,53069,Wahkiakum County,1711,1150,2931,561,0.583759809,0.392357557,0.191402252
Washington,53071,Walla Walla County,12068,10705,23379,1363,0.516189743,0.457889559,0.058300184
Washington,53073,Whatcom County,50041,82809,137032,-32768,0.365177477,0.604304104,-0.239126627
Washington,53075,Whitman County,7245,8794,16653,-1549,0.435056747,0.52807302,-0.093016273
Washington,53077,Yakima County,35017,28967,65221,6050,0.536897625,0.444136091,0.092761534
West Virginia,54001,Barbour County,5094,1438,6634,3656,0.767862526,0.216762134,0.551100392
West Virginia,54003,Berkeley County,32062,16075,49146,15987,0.652382696,0.32708664,0.325296057
West Virginia,54005,Boone County,6775,2029,8983,4746,0.754202382,0.22587109,0.528331292
West Virginia,54007,Braxton County,4115,1453,5650,2662,0.728318584,0.257168142,0.471150442
West Virginia,54009,Brooke County,7516,2936,10631,4580,0.706988994,0.276173455,0.430815539
West Virginia,54011,Cabell County,21440,14733,36795,6707,0.582687865,0.400407664,0.182280201
West Virginia,54013,Calhoun County,2346,563,2948,1783,0.795793758,0.190976934,0.604816825
West Virginia,54015,Clay County,2661,640,3346,2021,0.795277944,0.191273162,0.604004782
West Virginia,54017,Doddridge County,2592,432,3069,2160,0.84457478,0.140762463,0.703812317
West Virginia,54019,Fayette County,11514,5031,16794,6483,0.685602001,0.299571275,0.386030725
West Virginia,54021,Gilmer County,1997,591,2639,1406,0.756726033,0.223948465,0.532777567
West Virginia,54023,Grant County,4861,605,5497,4256,0.884300528,0.110060033,0.774240495
West Virginia,54025,Greenbrier County,10898,4641,15827,6257,0.688570165,0.293233083,0.395337082
West Virginia,54027,Hampshire County,7829,1919,9872,5910,0.793051053,0.194388169,0.598662885
West Virginia,54029,Hancock County,9653,3670,13546,5983,0.712608888,0.270928687,0.441680201
West Virginia,54031,Hardy County,4827,1371,6287,3456,0.767774773,0.218069031,0.549705742
West Virginia,54033,Harrison County,20581,9149,30375,11432,0.677563786,0.301201646,0.37636214
West Virginia,54035,Jackson County,10025,3197,13429,6828,0.746518728,0.23806687,0.508451858
West Virginia,54037,Jefferson County,14813,11831,27163,2982,0.545337408,0.435555719,0.109781688
West Virginia,54039,Kanawha County,46086,34139,82001,11947,0.562017536,0.416324191,0.145693345
West Virginia,54041,Lewis County,5759,1531,7423,4228,0.775831874,0.206250842,0.569581032
West Virginia,54043,Lincoln County,5967,1703,7775,4264,0.767459807,0.21903537,0.548424437
West Virginia,54045,Logan County,10501,2325,12981,8176,0.808951545,0.179107927,0.629843618
West Virginia,54047,McDowell County,5125,1323,6494,3802,0.789190022,0.203726517,0.585463505
West Virginia,54049,Marion County,16218,8836,25704,7382,0.630952381,0.343759726,0.287192655
West Virginia,54051,Marshall County,10137,3348,13666,6789,0.741767891,0.24498756,0.496780331
West Virginia,54053,Mason County,8422,2511,11149,5911,0.755404072,0.225221993,0.530182079
West Virginia,54055,Mercer County,19185,5522,25103,13663,0.764251285,0.219973708,0.544277576
West Virginia,54057,Mineral County,9904,2579,12652,7325,0.782801138,0.20384129,0.578959848
West Virginia,54059,Mingo County,8521,1385,9987,7136,0.853209172,0.138680284,0.714528888
West Virginia,54061,Monongalia County,20656,20064,41873,592,0.493301173,0.479163184,0.014137989
West Virginia,54063,Monroe County,5012,1330,6417,3682,0.781050335,0.20726196,0.573788375
West Virginia,54065,Morgan County,6157,1945,8257,4212,0.74567034,0.235557709,0.510112632
West Virginia,54067,Nicholas County,8221,2206,10570,6015,0.777767266,0.208703879,0.569063387
West Virginia,54069,Ohio County,12226,7139,19674,5087,0.621429298,0.362864695,0.258564603
West Virginia,54071,Pendleton County,2764,816,3646,1948,0.758091059,0.223806912,0.534284147
West Virginia,54073,Pleasants County,2726,692,3467,2034,0.786270551,0.199596193,0.586674358
West Virginia,54075,Pocahontas County,2876,1039,3979,1837,0.722794672,0.261120885,0.461673787
West Virginia,54077,Preston County,11143,3147,14508,7996,0.768059002,0.216914806,0.551144196
West Virginia,54079,Putnam County,19921,7824,28410,12097,0.701196762,0.275395987,0.425800774
West Virginia,54081,Raleigh County,24297,7841,32640,16456,0.744393382,0.240226716,0.504166667
West Virginia,54083,Randolph County,8655,3353,12172,5302,0.711058166,0.275468288,0.435589878
West Virginia,54085,Ritchie County,3637,585,4269,3052,0.851955962,0.137034434,0.714921527
West Virginia,54087,Roane County,4199,1451,5745,2748,0.730896432,0.25256745,0.478328982
West Virginia,54089,Summers County,4068,1444,5583,2624,0.728640516,0.258642307,0.469998209
West Virginia,54091,Taylor County,5439,1787,7334,3652,0.741614399,0.243659667,0.497954731
West Virginia,54093,Tucker County,2833,933,3830,1900,0.739686684,0.243603133,0.496083551
West Virginia,54095,Tyler County,3183,626,3873,2557,0.821843532,0.16163181,0.660211722
West Virginia,54097,Upshur County,7721,2247,10161,5474,0.759866155,0.221139652,0.538726503
West Virginia,54099,Wayne County,12462,3964,16735,8498,0.744666866,0.236868838,0.507798028
West Virginia,54101,Webster County,2737,608,3378,2129,0.810242747,0.179988159,0.630254589
West Virginia,54103,Wetzel County,4933,1529,6596,3404,0.747877502,0.231807156,0.516070346
West Virginia,54105,Wirt County,2103,461,2617,1642,0.803591899,0.176155904,0.627435995
West Virginia,54107,Wood County,77201,37507,116703,39694,0.661516842,0.321388482,0.34012836
West Virginia,54109,Wyoming County,7254,1149,8485,6105,0.854920448,0.135415439,0.719505009
Wisconsin,55001,Adams County,7362,4329,11808,3033,0.62347561,0.366615854,0.256859756
Wisconsin,55003,Ashland County,3845,4794,8744,-949,0.439730101,0.548261665,-0.108531565
Wisconsin,55005,Barron County,15803,9194,25345,6609,0.623515486,0.362753995,0.260761491
Wisconsin,55007,Bayfield County,4617,6155,10885,-1538,0.42416169,0.565457051,-0.141295361
Wisconsin,55009,Brown County,75865,65509,144011,10356,0.526800036,0.454888863,0.071911173
Wisconsin,55011,Buffalo County,4834,2859,7811,1975,0.618870823,0.366022276,0.252848547
Wisconsin,55013,Burnett County,6461,3569,10141,2892,0.637116655,0.351937679,0.285178976
Wisconsin,55015,Calumet County,18142,12115,30858,6027,0.587918854,0.392604835,0.195314019
Wisconsin,55017,Chippewa County,21316,14001,35945,7315,0.593017109,0.389511754,0.203505355
Wisconsin,55019,Clark County,10001,4520,14873,5481,0.672426545,0.303906408,0.368520137
Wisconsin,55021,Columbia County,16925,16408,33917,517,0.499012295,0.483769201,0.015243093
Wisconsin,55023,Crawford County,4620,3953,8698,667,0.531156588,0.454472292,0.076684295
Wisconsin,55025,Dane County,78789,260157,344745,-181368,0.228542836,0.754636035,-0.526093199
Wisconsin,55027,Dodge County,31354,16355,48497,14999,0.646514217,0.337237355,0.309276862
Wisconsin,55029,Door County,9752,10044,20117,-292,0.48476413,0.499279217,-0.014515087
Wisconsin,55031,Douglas County,10919,13214,24668,-2295,0.442638236,0.535673747,-0.093035512
Wisconsin,55033,Dunn County,13176,9909,23543,3267,0.559656798,0.420889436,0.138767362
Wisconsin,55035,Eau Claire County,25339,31617,58235,-6278,0.435116339,0.542920924,-0.107804585
Wisconsin,55037,Florence County,2133,781,2939,1352,0.72575706,0.265736645,0.460020415
Wisconsin,55039,Fond du Lac County,35754,20588,57322,15166,0.623739576,0.359164021,0.264575556
Wisconsin,55041,Forest County,3287,1722,5052,1565,0.650633413,0.340855107,0.309778306
Wisconsin,55043,Grant County,13981,10942,25379,3039,0.55088853,0.431143859,0.119744671
Wisconsin,55045,Green County,10165,10850,21400,-685,0.475,0.507009346,-0.032009346
Wisconsin,55047,Green Lake County,7165,3344,10663,3821,0.671949733,0.313607803,0.35834193
Wisconsin,55049,Iowa County,5907,7828,13984,-1921,0.422411327,0.559782609,-0.137371281
Wisconsin,55051,Iron County,2439,1533,4031,906,0.605060779,0.380302654,0.224758125
Wisconsin,55053,Jackson County,5789,4255,10187,1534,0.568273289,0.417689212,0.150584078
Wisconsin,55055,Jefferson County,27209,19904,47967,7305,0.567244147,0.414951946,0.152292201
Wisconsin,55057,Juneau County,8749,4747,13702,4002,0.638519924,0.346445774,0.29207415
Wisconsin,55059,Kenosha County,44972,42191,88691,2781,0.507063851,0.475707794,0.031356056
Wisconsin,55061,Kewaunee County,7927,3977,12071,3950,0.656697871,0.329467318,0.327230553
Wisconsin,55063,La Crosse County,28683,37843,67848,-9160,0.422753803,0.557761467,-0.135007664
Wisconsin,55065,Lafayette County,4820,3647,8557,1173,0.563281524,0.426200771,0.137080753
Wisconsin,55067,Langlade County,7330,3703,11159,3627,0.656868895,0.331839771,0.325029124
Wisconsin,55069,Lincoln County,10017,6260,16531,3757,0.605952453,0.378682475,0.227269978
Wisconsin,55071,Manitowoc County,27217,16817,44808,10400,0.607413855,0.375312444,0.23210141
Wisconsin,55073,Marathon County,44623,30807,76741,13816,0.581475352,0.401441211,0.180034141
Wisconsin,55075,Marinette County,15303,7363,22977,7940,0.66601384,0.320450886,0.345562954
Wisconsin,55077,Marquette County,5719,3239,9060,2480,0.631236203,0.357505519,0.273730684
Wisconsin,55078,Menominee County,278,1303,1586,-1025,0.175283733,0.821563682,-0.64627995
Wisconsin,55079,Milwaukee County,134355,317251,458935,-182896,0.292753876,0.691276542,-0.398522667
Wisconsin,55081,Monroe County,13775,8432,22564,5343,0.610485729,0.373692608,0.236793122
Wisconsin,55083,Oconto County,16226,6715,23214,9511,0.698974757,0.289265099,0.409709658
Wisconsin,55085,Oneida County,13671,10105,24159,3566,0.565876071,0.418270624,0.147605447
Wisconsin,55087,Outagamie County,58379,47659,108223,10720,0.539432468,0.440377739,0.09905473
Wisconsin,55089,Ozaukee County,33912,26515,61453,7397,0.551836363,0.431467951,0.120368412
Wisconsin,55091,Pepin County,2584,1489,4140,1095,0.624154589,0.359661836,0.264492754
Wisconsin,55093,Pierce County,12813,9789,23336,3024,0.549065821,0.419480631,0.12958519
Wisconsin,55095,Polk County,16590,9361,26326,7229,0.630175492,0.355580035,0.274595457
Wisconsin,55097,Portage County,19298,20426,40601,-1128,0.47530849,0.503091057,-0.027782567
Wisconsin,55099,Price County,5394,3132,8645,2262,0.623944477,0.362290341,0.261654135
Wisconsin,55101,Racine County,54475,50154,106441,4321,0.511785872,0.471190613,0.040595259
Wisconsin,55103,Richland County,4877,3995,9016,882,0.54092724,0.443101154,0.097826087
Wisconsin,55105,Rock County,37133,46649,85348,-9516,0.435077565,0.546574026,-0.111496462
Wisconsin,55107,Rusk County,5257,2517,7881,2740,0.667047329,0.319375714,0.347671615
Wisconsin,55109,St. Croix County,32190,23190,56701,9000,0.567714855,0.408987496,0.158727359
Wisconsin,55111,Sauk County,17489,18103,36249,-614,0.482468482,0.49940688,-0.016938398
Wisconsin,55113,Sawyer County,5883,4494,10479,1389,0.561408531,0.428857715,0.132550816
Wisconsin,55115,Shawano County,15447,7131,22878,8316,0.675190139,0.311696827,0.363493312
Wisconsin,55117,Sheboygan County,37624,27109,66020,10515,0.569887913,0.410617995,0.159269918
Wisconsin,55119,Taylor County,7656,2693,10683,4963,0.716652626,0.252082748,0.464569877
Wisconsin,55121,Trempealeau County,8828,6283,15356,2545,0.574889294,0.40915603,0.165733264
Wisconsin,55123,Vernon County,8216,7457,15910,759,0.516404777,0.468698931,0.047705845
Wisconsin,55125,Vilas County,9261,5903,15338,3358,0.603794497,0.384861129,0.218933368
Wisconsin,55127,Walworth County,33844,22783,57588,11061,0.58769188,0.395620615,0.192071265
Wisconsin,55129,Washburn County,6332,3867,10371,2465,0.610548645,0.372866647,0.237681998
Wisconsin,55131,Washington County,60235,26647,88254,33588,0.682518639,0.301935323,0.380583316
Wisconsin,55133,Waukesha County,159633,103867,267957,55766,0.595741108,0.387625626,0.208115481
Wisconsin,55135,Waupaca County,18948,9699,29118,9249,0.650731506,0.333092932,0.317638574
Wisconsin,55137,Waushara County,9016,4388,13564,4628,0.664700678,0.323503391,0.341197287
Wisconsin,55139,Winnebago County,47795,44060,94032,3735,0.508284414,0.468563893,0.039720521
Wisconsin,55141,Wood County,24307,16360,41197,7947,0.590018691,0.397116295,0.192902396
Wyoming,56001,Albany County,8575,9091,18612,-516,0.460724264,0.488448313,-0.027724049
Wyoming,56003,Big Horn County,4806,788,5752,4018,0.835535466,0.136995828,0.698539638
Wyoming,56005,Campbell County,16973,1935,19564,15038,0.867562871,0.098906154,0.768656716
Wyoming,56007,Carbon County,5012,1427,6662,3585,0.752326629,0.21419994,0.538126689
Wyoming,56009,Converse County,5916,861,6969,5055,0.848902282,0.123547137,0.725355144
Wyoming,56011,Crook County,3651,378,4119,3273,0.886380189,0.091769847,0.794610342
Wyoming,56013,Fremont County,12007,5519,18111,6488,0.662967257,0.304731931,0.358235327
Wyoming,56015,Goshen County,4878,1203,6241,3675,0.781605512,0.192757571,0.588847941
Wyoming,56017,Hot Springs County,1999,482,2577,1517,0.775708188,0.187039193,0.588668995
Wyoming,56019,Johnson County,3881,897,4914,2984,0.78978429,0.182539683,0.607244607
Wyoming,56021,Laramie County,27814,15181,44865,12633,0.619948735,0.338370668,0.281578068
Wyoming,56023,Lincoln County,8673,1509,10498,7164,0.826157363,0.143741665,0.682415698
Wyoming,56025,Natrona County,25267,8528,35196,16739,0.717894079,0.242300261,0.475593817
Wyoming,56027,Niobrara County,1118,155,1308,963,0.854740061,0.118501529,0.736238532
Wyoming,56029,Park County,12802,3404,16699,9398,0.766632732,0.203844542,0.562788191
Wyoming,56031,Platte County,3898,890,4923,3008,0.791793622,0.180784075,0.611009547
Wyoming,56033,Sheridan County,11843,4043,16428,7800,0.720903336,0.246104212,0.474799123
Wyoming,56035,Sublette County,3957,882,4970,3075,0.796177062,0.177464789,0.618712274
Wyoming,56037,Sweetwater County,12197,3822,16489,8375,0.739705258,0.231790891,0.507914367
Wyoming,56039,Teton County,4341,9848,14677,-5507,0.29576889,0.670981808,-0.375212918
Wyoming,56041,Uinta County,7494,1591,9400,5903,0.797234043,0.169255319,0.627978723
Wyoming,56043,Washakie County,3245,651,4012,2594,0.808823529,0.16226321,0.646560319
Wyoming,56045,Weston County,3107,360,3542,2747,0.877188029,0.101637493,0.775550536